ABIES-C ------> ABIES CANADENSIS-PINUS CANADENSIS
ABIES-N ------> ABIES NIGRA
ABR ------> ABRUS PRECATORIUS - JEQUIRITY (JEQUIRITY - ARBRUS PRECATORIUS)
ABROT ------> ABROTANUM
ABSIN ------> ABSINTHIUM
ACAL ------> ACALYPHA INDICA
ACET-AC ------> ACETICUM ACIDUM (ACETIC ACID)
ACETAN ------> ACETANILIDUM
ACON ------> ACONITUM NAPELLUS
ACT-SP ------> ACTAEA SPICATA (ACTEA SPICATA)
ADON ------> ADONIS VERNALIS
ADREN ------> ADRENALINUM (ADRENALIN)
AESC ------> AESCULUS HIPPOCASTANUM
AETH ------> AETHUSA CYNAPIUM
AETHI-M ------> AETHIOPS MINERALIS (AETHIOPS MERCURIALIS-MINERALIS)
AGAR ------> AGARICUS MUSCARIUS (AGARICUS MUSCARIUS-AMANITA)
AGAV-A ------> AGAVE AMERICANA
AGN ------> AGNUS CASTUS
AGRA ------> AGRAPHIS NUTANS
AIL ------> AILANTHUS GLANDULOSA
ALET ------> ALETRIS FARINOSA
ALF ------> ALFALFA
ALL-C ------> ALLIUM CEPA
ALL-S ------> ALLIUM SATIVUM
ALN ------> ALNUS RUBRA (ALNUS)
ALOE ------> ALOE SOCOTRINA (ALOE)
ALST-S ------> ALSTONIA SCHOLARIS
ALUM ------> ALUMINA
ALUM-SIL ------> ALUMINA SILICATA
ALUMN ------> ALUMEN
AM-BE ------> AMMONIUM BENZOICUM
AM-BR ------> AMMONIUM BROMATUM
AM-C ------> AMMONIUM CARBONICUM (AMMONIUM CARB)
AM-CAUST ------> AMMONIUM CAUSTICUM
AM-I ------> AMMONIUM IODATUM (AMMONIUM JODATUM)
AM-M ------> AMMONIUM MURIATICUM
AM-P ------> AMMONIUM PHOSPHORICUM
AM-PIC ------> AMMONIUM PICRICUM (AMMONIUM PICRATUM)
AM-VAL ------> AMMONIUM VALERIANICUM
AMBR ------> AMBRA GRISEA
AMBRO ------> AMBROSIA ARTEMISIAEFOLIA (AMBROSIA)
AMGD-P ------> AMYGDALUS PERSICA
AML-NS ------> AMYLENUM NITROSUM (AMYL NITROSUM)
AMMC ------> AMMONIACUM GUMMI (AMMONIACUM-DOREMA)
AMPE-QU ------> AMPELOPSIS QUINQUEFOLIA (AMPELOPSIS)
ANAC ------> ANACARDIUM ORIENTALE (ANACARDIUM)
ANAG ------> ANAGALLIS ARVENSIS (ANAGALLIS)
ANAN ------> ANANTHERUM MURICATUM (ANATHERUM)
ANEMPS ------> ANEMOPSIS CALIFORNICA
ANG ------> ANGUSTURA VERA
ANH ------> ANHALONIUM LEWINII (ANHALONIUM)
ANIL ------> ANILINUM
ANIS ------> ANISUM STELLATUM (ILLICIUM)
ANT-AR ------> ANTIMONIUM ARSENICOSUM
ANT-C ------> ANTIMONIUM CRUDUM
ANT-SAUR ------> ANTIMONIUM SULPHURATUM AURATUM
ANT-T ------> ANTIMONIUM TARTARICUM
ANTH ------> ANTHEMIS NOBILIS
ANTHRACI ------> ANTHRACINUM
ANTHRACO ------> ANTHRACOKALI (ANTHRAKOKALI)
ANTIP ------> ANTIPYRINUM (ANTIPYRINE)
AP-G ------> APIUM GRAVEOLENS
APHIS ------> APHIS CHENOPODII GLAUCI (CHENOPODI GLAUCI APHIS)
APIS ------> APIS MELLIFICA
APOC ------> APOCYNUM CANNABINUM
APOC-A ------> APOCYNUM ANDROSAEMIFOLIUM
APOM ------> APOMORPHINUM (APOMORPHIA)
AQUI ------> AQUILEGIA VULGARIS (AQUILEGIA)
ARAG ------> ARAGALLUS LAMBERTI
ARAL ------> ARALIA RACEMOSA
ARAN ------> ARANEA DIADEMA
ARB ------> ARBUTUS ANDRACHNE
AREC ------> ARECA CATECHU (ARECA)
ARG-MET ------> ARGENTUM METALLICUM
ARG-N ------> ARGENTUM NITRICUM
ARGE ------> ARGEMONE MEXICANA
ARIST-M ------> ARISTOLOCHIA MILHOMENS
ARN ------> ARNICA MONTANA (ARNICA)
ARS ------> ARSENICUM ALBUM
ARS-BR ------> ARSENICUM BROMATUM
ARS-H ------> ARSENICUM HYDROGENISATUM
ARS-I ------> ARSENICUM IODATUM
ARS-MET ------> ARSENICUM METALLICUM
ARS-S-F ------> ARSENICUM SULPHURATUM FLAVUM (ARSENIC TRISULPH.)
ART-V ------> ARTEMISIA VULGARIS
ARUM-D ------> ARUM DRACONTIUM
ARUM-T ------> ARUM TRIPHYLLUM
ARUND ------> ARUNDO MAURITANICA (ARUNDO)
ASAF ------> ASA FOETIDA (ASAFOETIDA)
ASAR ------> ASARUM EUROPAEUM (ASARUM EUROPUM)
ASC-C ------> ASCLEPIAS CORNUTI (ASCLEPIAS SYRIACA)
ASC-T ------> ASCLEPIAS TUBEROSA
ASIM ------> ASIMINA TRILOBA
ASPAR ------> ASPARAGUS OFFICINALIS
ASTAC ------> ASTACUS FLUVIATILIS (CANCER ASTACUS)
ASTER ------> ASTERIAS RUBENS
ASTRA-MO ------> ASTRAGALUS MOLLISSIMUS
AUR ------> AURUM METALLICUM
AUR-M-N ------> AURUM MURIATICUM NATRONATUM
AVEN ------> AVENA SATIVA
AZA ------> AZADIRACHTA INDICA
BAC ------> BACILLINUM BURNETT (BACILLINUM)
BAD ------> BADIAGA
BALS-P ------> BALSAMUM PERUVIANUM
BAPT ------> BAPTISIA TINCTORIA (BAPTISIA)
BAR-ACT ------> BARYTA ACETICA
BAR-C ------> BARYTA CARBONICA (BARYTA CARB)
BAR-I ------> BARYTA IODATA
BAR-M ------> BARYTA MURIATICA
BAROS ------> BAROSMA CRENULATUM (BAROSMA CRENATA)
BELL ------> BELLADONNA
BELL-P ------> BELLIS PERENNIS
BENZ-AC ------> BENZOICUM ACIDUM
BENZOL ------> BENZOLUM (BENZENUM - COAL NAPHTHA)
BERB ------> BERBERIS VULGARIS
BERB-A ------> BERBERIS AQUIFOLIUM (BERBERIS AQUIFOLIUM - MAHONIA)
BETA ------> BETA VULGARIS
BISM-SN ------> BISMUTHUM SUBNITRICUM (BISMUTHUM)
BLATTA-A ------> BLATTA AMERICANA
BLATTA-O ------> BLATTA ORIENTALIS
BOL-LA ------> BOLETUS LARICIS (POLYPORUS OFFICINALE)
BOR-AC ------> BORICUM ACIDUM
BORX ------> BORAX VENETA (BORAX)
BOTH ------> BOTHROPS LANCEOLATUS (BOTHROPS LANCIOLATUS - LACHESIS LANCIOLATUS)
BOTUL ------> BOTULINUM
BOV ------> BOVISTA LYCOPERDON (BOVISTA)
BRACH ------> BRACHYGLOTTIS REPENS (BRACHYGLOTTIS)
BROM ------> BROMIUM (BROMUM)
BRY ------> BRYONIA ALBA (BRYONIA)
BUFO ------> BUFO RANA (BUFO)
BUT-AC ------> BUTYRICUM ACIDUM (BUTYRIC ACID)
CACT ------> CACTUS GRANDIFLORUS (SELENICEREUS SPINULOSUS)
CADM-S ------> CADMIUM SULPHURATUM
CAIN ------> CAINCA (CAHINCA)
CAJ ------> CAJUPUTUM (OLEUM WITTNEBIANUM)
CALAD ------> CALADIUM SEGUINUM
CALC ------> CALCAREA CARBONICA (CALCAREA CARBONICA - OSTREARUM)
CALC-ACT ------> CALCAREA ACETICA
CALC-AR ------> CALCAREA ARSENICOSA (CALCAREA ARSENICA)
CALC-F ------> CALCAREA FLUORICA (FLUOR SPAR)
CALC-I ------> CALCAREA IODATA
CALC-P ------> CALCAREA PHOSPHORICA
CALC-S ------> CALCAREA SULPHURICA
CALC-SIL ------> CALCAREA SILICATA
CALEN ------> CALENDULA OFFICINALIS
CALO ------> CALOTROPIS GIGANTEA (CALOTROPIS)
CALTH ------> CALTHA PALUSTRIS
CAMPH ------> CAMPHORA
CAMPH-BR ------> CAMPHORA BROMATA (CAMPHORA MONO-BROMATA)
CANCH ------> CANCHALAGUA
CANN-I ------> CANNABIS INDICA
CANN-S ------> CANNABIS SATIVA
CANTH ------> CANTHARIS VESICATORIA (CANTHARIS)
CAPS ------> CAPSICUM ANNUUM (CAPSICUM)
CARB-AC ------> CARBOLICUM ACIDUM
CARB-AN ------> CARBO ANIMALIS
CARB-V ------> CARBO VEGETABILIS
CARBN-H ------> CARBONEUM HYDROGENISATUM
CARBN-O ------> CARBONEUM OXYGENISATUM
CARBN-S ------> CARBONEUM SULPHURATUM
CARC ------> CARCINOSINUM (CARCINOSIN)
CARD-M ------> CARDUUS MARIANUS
CARL ------> CARLSBAD AQUA (CARLSBAD)
CAS-S ------> CASCARA SAGRADA (RHAMNUS PURSHIANA)
CASC ------> CASCARILLA
CAST ------> CASTOREUM CANADENSE (CASTOREUM)
CASTN-V ------> CASTANEA VESCA
CASTOR-E ------> CASTOR EQUI
CATAR ------> CATARIA NEPETA
CAUL ------> CAULOPHYLLUM THALICTROIDES (CAULOPHYLLUM)
CAUST ------> CAUSTICUM
CEAN ------> CEANOTHUS AMERICANUS (CEANOTHUS)
CEDR ------> CEDRON (SIMARUBA FERROGINEA)
CENCH ------> CENCHRIS CONTORTRIX (ANCISTRODON)
CER-OX ------> CERIUM OXALICUM
CERE-B ------> CEREUS BONPLANDII
CHAM ------> CHAMOMILLA
CHAP ------> CHAPARRO AMARGOSO
CHEL ------> CHELIDONIUM MAJUS
CHELO ------> CHELONE GLABRA (CHELONE)
CHEN-A ------> CHENOPODIUM ANTHELMINTICUM
CHIM ------> CHIMAPHILA UMBELLATA
CHIN ------> CHINA OFFICINALIS (CINCHONA OFFICINALIS)
CHININ-A ------> CHININUM ARSENICOSUM
CHININ-S ------> CHININUM SULPHURICUM
CHION ------> CHIONANTHUS VIRGINICA (CHIONANTHUS)
CHLF ------> CHLOROFORMIUM (CHLOROFORMUM)
CHLOL ------> CHLORALUM HYDRATUM (CHLORALUM)
CHLOR ------> CHLORUM
CHOL ------> CHOLESTERINUM
CHR-AC ------> CHROMICUM ACIDUM
CHRYSAR ------> CHRYSAROBINUM
CIC ------> CICUTA VIROSA
CIMIC ------> CIMICIFUGA RACEMOSA (CIMICIFUGA - ACTAEA RACEMOSA - MACROTYS)
CIMX ------> CIMEX LECTULARIUS (CIMEX - ACANTHIA)
CINA ------> CINA MARITIMA (CINA)
CINE ------> CINERARIA MARITIMA (CINERARIA)
CINNB ------> CINNABARIS (MERCURIUS SULPHURATUS RUBER)
CINNM ------> CINNAMOMUM CEYLANICUM (CINNAMOMUM)
CIST ------> CISTUS CANADENSIS
CIT-V ------> CITRUS VULGARIS
CLEM ------> CLEMATIS ERECTA
COB ------> COBALTUM METALLICUM (COBALTUM)
COC-C ------> COCCUS CACTI
COCA ------> COCA-ERYTHROXYLON COCA
COCAIN ------> COCAINUM HYDROCHLORICUM (COCAINA)
COCC ------> COCCULUS INDICUS (COCCULUS)
COCC-S ------> COCCINELLA SEPTEMPUNCTATA
COCH ------> COCHLEARIA ARMORACIA (ARMORACIA SATIVA)
COD ------> CODEINUM
COFF ------> COFFEA CRUDA
COLCH ------> COLCHICUM AUTUMNALE (COLCHICUM)
COLL ------> COLLINSONIA CANADENSIS
COLOC ------> COLOCYNTHIS
CON ------> CONIUM MACULATUM (CONIUM)
COM ------> COMOCLADIA DENTATA
CONV ------> CONVALLARIA MAJALIS
COP ------> COPAIVA OFFICINALIS (COPAIVA)
COR-R ------> CORALLIUM RUBRUM (CORALLIUM)
CORH ------> CORALLORHIZA ODONTORHIZA (CORALLORHIZA)
CORN ------> CORNUS CIRCINATA
CORY ------> CORYDALIS FORMOSA (CORYDALIS - DICENTRA CANADENSIS)
COT ------> COTYLEDON UMBILICUS (COTYLEDON)
CRAT ------> CRATAEGUS OXYACANTHA (CRATAEGUS)
CROC ------> CROCUS SATIVUS (CROCUS SATIA)
CROT-H ------> CROTALUS HORRIDUS
CROT-T ------> CROTON TIGLIUM
CUB ------> CUBEBA OFFICINALIS (CUBEBA)
CUC-C ------> CUCURBITA CITRULLUS
CUC-P ------> CUCURBITA PEPO
CUND ------> CUNDURANGO (CONDURANGO)
CUPH ------> CUPHEA VISCOSISSIMA (CUPHEA)
CUPR ------> CUPRUM METALLICUM
CUPR-ACT ------> CUPRUM ACETICUM
CUPR-AR ------> CUPRUM ARSENICOSUM
CUR ------> CURARE (WOORARI)
CYCL ------> CYCLAMEN EUROPAEUM (CYCLAMEN)
CYPR ------> CYPRIPEDIUM PUBESCENS (CYPRIPEDIUM)
CYT-L ------> CYTISUS LABURNUM (LABURNUM)
DAM ------> DAMIANA (TURNERA)
DAPH ------> DAPHNE INDICA
DIG ------> DIGITALIS PURPUREA (DIGITALIS)
DIOS ------> DIOSCOREA VILLOSA
DIOSM ------> DIOSMA LINCARIS
DIPH ------> DIPHTHERINUM
DOL ------> DOLICHOS PRURIENS (DOLICHOS PURIENS - MUCUNA)
DOR ------> DORYPHORA DECEMLINEATA (DORYPHORA)
DROS ------> DROSERA ROTUNDIFOLIA (DROSERA)
DUBO-M ------> DUBOISIA MYOPOROIDES (DUBOISIA)
DULC ------> DULCAMARA
ECHI ------> ECHINACEA ANGUSTIFOLIA (ECHINACEA - RUDBECKIA)
ELAPS ------> ELAPS CORALLINUS
ELAT ------> ELATERIUM OFFICINARUM (ELATERIUM - ECBALIUM)
EOS ------> EOSINUM (EOSIN)
EPIG ------> EPIGEA REPENS
EPIPH ------> EPIPHEGUS VIRGINIANA (EPIPHEGUS - OROBANCHE)
EQUIS-H ------> EQUISETUM HYEMALE (EQUISETUM)
ERECH ------> ERECHTHITES HIERACIFOLIA (ERECHTHITES)
ERIG ------> ERIGERON CANADENSE (ERIGERON - LEPTILON CANADENSE)
ERIO ------> ERIODYCTION CALIFORNICUM (ERIODICTYON)
ERY-A ------> ERYNGIUM AQUATICUM
ESCH ------> ESCHSCHOLTZIA CALIFORNICA
EUCAL ------> EUCALYPTUS GLOBULUS
EUG ------> EUGENIA JAMBOS (JAMBOSA VULGARIS)
EUON-A ------> EUONYMUS ATROPURPUREA
EUP-A ------> EUPATORIUM AROMATICUM
EUP-PER ------> EUPATORIUM PERFOLIATUM
EUP-PUR ------> EUPATORIUM PURPUREUM
EUPH ------> EUPHORBIUM OFFICINARUM (EUPHORBIUM)
EUPH-L ------> EUPHORBIA LATHYRIS
EUPH-PO ------> EUPHORBIA POLYCARPA (GOLONDRINA)
EUPHR ------> EUPHRASIA OFFICINALIS (EYEBRIGHT)
EUPI ------> EUPIONUM (EUPION)
FAB ------> FABIANA IMBRICATA
FAGO ------> FAGOPYRUM ESCULENTUM (FAGOPYRUM)
FEL ------> FEL TAURI
FERR ------> FERRUM METALLICUM
FERR-I ------> FERRUM IODATUM
FERR-MA ------> FERRUM MAGNETICUM
FERR-P ------> FERRUM PHOSPHORICUM
FERR-PIC ------> FERRUM PICRICUM
FIC-R ------> FICUS RELIGIOSA
FIL ------> FILIX MAS (ASPIDIUM)
FL-AC ------> FLUORICUM ACIDUM
FORM ------> FORMICA RUFA (MYRMEXINE)
FORMAL ------> FORMALINUM (FORMALIN)
FRAG ------> FRAGARIA VESCA (FRAGARIA)
FRANC ------> FRANCISCEA UNIFLORA (FRACISCEA)
FRAX ------> FRAXINUS AMERICANA
FUC ------> FUCUS VESICULOSUS
FUCH ------> FUCHSINUM (FUCHSINA - MAGENTA)
FULI ------> FULIGO LIGNI
GAL-AC ------> GALLICUM ACIDUM
GALA ------> GALANTHUS NIVALIS
GALI ------> GALIUM APARINE
GAMB ------> GAMBOGIA (GAMBOGIA - GARCINIA MORELLA)
GAUL ------> GAULTHERIA PROCUMBENS (GAULTHERIA)
GELS ------> GELSEMIUM SEMPERVIRENS (GELSEMIUM)
GENT-L ------> GENTIANA LUTEA
GER ------> GERANIUM MACULATUM
GET ------> GETTYSBURG WATER
GINS ------> GINSENG QUINQUEFOLIUM (GINSENG)
GLON ------> GLONOINUM
GLYC ------> GLYCERINUM
GNAPH ------> GNAPHALIUM POLYCEPHALUM (GNAPHALIUM)
GOSS ------> GOSSYPIUM HERBACEUM (GOSSYPIUM)
GRAN ------> GRANATUM
GRAPH ------> GRAPHITES
GRAT ------> GRATIOLA OFFICINALIS (GRATIOLA)
GRIN ------> GRINDELIA ROBUSTA (GRINDELIA)
GUA ------> GUACO
GUAJ ------> GUAJACUM OFFICINALE (GUAIACUM)
GUAR ------> GUARANA (PAULLINIA SORBILIS)
GUARE ------> GUAREA TRICHILOIDES (GUAREA)
GYMNO ------> GYMNOCLADUS CANADENSIS (GYMNOCLADUS)
HAEM ------> HAEMATOXYLON CAMPECHIANUM (HAEMATOXYLON)
HAM ------> HAMAMELIS VIRGINIANA (HAMAMELIS VIRGINICA)
HECLA ------> HECLA LAVA (HEKLA LAVA)
HEDEO ------> HEDEOMA PULEGIOIDES (HEDEOMA)
HELIA ------> HELIANTHUS ANNUUS (HELIANTHUS)
HELL ------> HELLEBORUS NIGER (HELLEBORUS)
HELO ------> HELODERMA
HELON ------> HELONIAS DIOICA (HELONIAS - CHAMAELIRIUM)
HEP ------> HEPAR SULPHUR (HEPAR SULPHURIS CALCAREUM)
HEPAT ------> HEPATICA TRILOBA (HEPATICA)
HERA ------> HERACLEUM SPHONDYLIUM (HERACLEUM - BRANCA URSINA)
HIP-AC ------> HIPPURICUM ACIDUM (HIPPURIC ACID)
HIPP ------> HIPPOMANES
HIPPOZ ------> HIPPOZAENINUM (HIPPOZAENIUM)
HOM ------> HOMARUS
HURA ------> HURA BRASILIENSIS
HYDR ------> HYDRASTIS CANADENSIS (HYDRASTIS)
HYDR-AC ------> HYDROCYANICUM ACIDUM (HYDROCYANIC ACID)
HYDRANG ------> HYDRANGEA ARBORESCENS (HYDRANGEA)
HYDRC ------> HYDROCOTYLE ASIATICA (HYDROCOTYLE)
HYOS ------> HYOSCYAMUS NIGER (HYOSCYAMUS)
HYPER ------> HYPERICUM PERFORATUM (HYPERICUM)
IBER ------> IBERIS AMARA (IBERIS)
ICHTH ------> ICHTHYOLUM
ICTOD ------> ICTODES FOETIDA (POTHOS FOETIDUS)
IGN ------> IGNATIA AMARA (IGNATIA)
ILX-A ------> ILEX AQUIFOLIUM
IND ------> INDIUM METALLICUM (INDIUM)
INDG ------> INDIGO TINCTORIA (INDIGO)
INDOL ------> INDOLUM (INDOL)
INS ------> INSULINUM (INSULIN)
INUL ------> INULA HELENIUM (INULA)
IOD ------> IODIUM (IODUM)
IODOF ------> IODOFORMIUM (IODOFORMUM)
IP ------> IPECACUANHA (IPECA)
IRID-MET ------> IRIDIUM METALLICUM (IRIDIUM)
IRIS ------> IRIS VERSICOLOR
JAB ------> JABORANDI (PILOCARPUS MICROPHYLLUS)
JAC-C ------> JACARANDA CAROBA (JACARANDA)
JAL ------> JALAPA (EXOGONIUM PURGA)
JATR ------> JATROPHA CURCAS (JATROPHA)
JOAN ------> JOANESIA ASOCA (JONOSIA ASOCA)
JUG-C ------> JUGLANS CINEREA
JUG-R ------> JUGLANS REGIA
JUNC-E ------> JUNCUS EFFUSUS
JUNI-C ------> JUNIPERUS COMMUNIS
JUST ------> JUSTICIA ADHATODA (JUSTICIA ADHATODA BASAKA)
KALI-AR ------> KALIUM ARSENICOSUM (KALI ARSENICUM)
KALI-BI ------> KALIUM BICHROMICUM (KALI BICHROMICUM)
KALI-BR ------> KALIUM BROMATUM (KALI BROMATUM)
KALI-C ------> KALIUM CARBONICUM (KALI CARBONICUM)
KALI-CHL ------> KALIUM CHLORICUM (KALI CHLORICUM)
KALI-CY ------> KALIUM CYANATUM (KALI CYANATUM)
KALI-I ------> KALIUM IODATUM (KALI HYDRIODICUM)
KALI-M ------> KALIUM MURIATICUM (KALI MURIATICUM)
KALI-N ------> KALIUM NITRICUM (KALI NITRICUM - NITRUM)
KALI-P ------> KALIUM PHOSPHORICUM (KALI PHOSPHORICUM)
KALI-PER ------> KALIUM PERMANGANATUM (KALI PERMANGANICUM)
KALI-S ------> KALIUM SULPHURICUM (KALI SULPHURICUM)
KALI-SIL ------> KALIUM SILICICUM (KALI SILICATUM)
KALM ------> KALMIA LATIFOLIA
KAOL ------> KAOLINUM (KAOLIN)
KOLA ------> KOLA (STERCULIA)
KOU ------> KOUSSO (KOUSSO - BRAYERA)
KREOS ------> KREOSOTUM
LAC-AC ------> LACTICUM ACIDUM
LAC-C ------> LAC CANINUM
LAC-D ------> LAC VACCINUM DEFLORATUM (LAC DEFLORATUM)
LACH ------> LACHESIS MUTUS (LACHESIS)
LACHN ------> LACHNANTHES TINCTORIA (LACHNANTHES)
LACT-V ------> LACTUCA VIROSA
LAM ------> LAMIUM ALBUM (LAMIUM)
LAP-A ------> LAPIS ALBUS
LAPPA ------> LAPPA ARCTIUM
LAT-M ------> LATRODECTUS MACTANS
LATH ------> LATHYRUS SATIVUS (LATHYRUS)
LAUR ------> LAUROCERASUS
LEC ------> LECITHINUM (LECITHIN)
LED ------> LEDUM PALUSTRE (LEDUM)
LEM-M ------> LEMNA MINOR
LEPI ------> LEPIDIUM BONARIENSE
LEPT ------> LEPTANDRA VIRGINICA (LEPTANDRA)
LIAT ------> LIATRIS SPICATA (LIATRIS SPICATA - SERRATULA)
LIL-T ------> LILIUM TIGRINUM
LIM ------> LIMULUS CYCLOPS (LIMULUS - XIPHOSURA)
LINA ------> LINARIA VULGARIS (LINARIA)
LINU-U ------> LINUM USITATISSIMUM
LITH-C ------> LITHIUM CARBONICUM
LOB ------> LOBELIA INFLATA
LOB-P ------> LOBELIA PURPURASCENS
LOL ------> LOLEUM TEMULENTUM (LOLIUM TUMULENTUM)
LON-X ------> LONICERA XYLOSTEUM
LUP ------> LUPULUS HUMULUS
LYC ------> LYCOPODIUM CLAVATUM (LYCOPODIUM)
LYCPR ------> LYCOPERSICUM ESCULENTUM (SOLANUM LYCOPERSICUM)
LYCPS-V ------> LYCOPUS VIRGINICUS
LYSS ------> LYSSINUM (HYDROPHOBINUM)
MAG-C ------> MAGNESIUM CARBONICUM (MAGNESIA CARBONICA)
MAG-M ------> MAGNESIUM MURIATICUM (MAGNESIA MURIATICA)
MAG-P ------> MAGNESIUM PHOSPHORICUM (MAGNESIA PHOSPHORICA)
MAG-S ------> MAGNESIUM SULPHURICUM (MAGNESIA SULPHURICA)
MAGN-GR ------> MAGNOLIA GRANDIFLORA
MALAND ------> MALANDRINUM
MANC ------> MANCINELLA
MANG-ACT ------> MANGANUM ACETICUM
MANGI ------> MANGIFERA INDICA
MED ------> MEDORRHINUM
MEDUS ------> MEDUSA
MEL-C-S ------> MEL CUM SALE
MELI ------> MELILOTUS OFFICINALIS (MELILOTUS)
MENIS ------> MENISPERMUM CANADENSE (MENISPERMUM)
MENTH ------> MENTHA PIPERITA
MENTHO ------> MENTHOLUM
MENY ------> MENYANTHES TRIFOLIATA (MENYANTHES)
MEPH ------> MEPHITIS PUTORIUS (MEPHITIS)
MERC ------> MERCURIUS SOLUBILIS (MERCURIUS - HYDRARGYRUM)
MERC-C ------> MERCURIUS CORROSIVUS
MERC-CY ------> MERCURIUS CYANATUS
MERC-D ------> MERCURIUS DULCIS
MERC-I-F ------> MERCURIUS IODATUS FLAVUS
MERC-I-R ------> MERCURIUS IODATUS RUBER
MERC-SUL ------> MERCURIUS SULPHURICUS, DRARG, OXYD, SUB-SULPH
MERL ------> MERCURIALIS PERENNIS
METHYL ------> METHYLENUM COERULEUM (METHYLENE BLUE)
MEZ ------> MEZEREUM
MICR ------> MICROMERIA DOUGLASII (MICROMERIA)
MILL ------> MILLEFOLIUM
MIT ------> MITCHELLA REPENS (MITCHELLA)
MOM-B ------> MOMORDICA BALSAMICA
MORPH ------> MORPHINUM
MOSCH ------> MOSCHUS
MUR-AC ------> MURIATICUM ACIDUM
MURX ------> MUREX PURPUREA (MUREX)
MYGAL ------> MYGALE LASIODORA
MYOS-S ------> MYOSOTIS SYMPHYTIFOLIA (MYOSOTIS)
MYRIC ------> MYRICA CERIFERA (MYRICA)
MYRIS ------> MYRISTICA SEBIFERA
MYRT-C ------> MYRTUS COMMUNIS
NAJA ------> NAJA TRIPUDIANS
NAPH ------> NAPHTHALINUM (NAPHTHALINE)
NARC-PS ------> NARCISSUS PSEUDONARCISSUS (NARCISSUS)
NAT-AR ------> NATRIUM ARSENICOSUM (NATRUM ARSENICUM)
NAT-C ------> NATRIUM CARBONICUM (NATRUM CARBONICUM)
NAT-HCHL ------> NATRIUM HYPOCHLOROSUM (NATRUM CHLORATUM)
NAT-M ------> NATRIUM MURIATICUM (NATRUM MURIATICUM)
NAT-N ------> NATRIUM NITRICUM (NATRUM NITRICUM)
NAT-P ------> NATRIUM PHOSPHORICUM
NAT-S ------> NATRIUM SULPHURICUM (NATRUM SULPHURICUM)
NAT-SAL ------> NATRIUM SALICYLICUM (NATRUM SALICYLICUM)
NICC-MET ------> NICCOLUM METALLICUM (NICCOLUM)
NICC-S ------> NICCOLUM SULPHURICUM
NIT-AC ------> NITRICUM ACIDUM
NIT-M-AC ------> NITROMURIATICUM ACIDUM (NITRO-MURIATIC ACID)
NIT-S-D ------> NITRI SPIRITUS DULCIS
NUPH ------> NUPHAR LUTEUM
NUX-M ------> NUX MOSCHATA
NUX-V ------> NUX VOMICA
NYCT ------> NYCTANTHES ARBOR TRISTIS
OCI ------> OCIMUM CANUM
OENA ------> OENANTHE CROCATA
OL-AN ------> OLEUM ANIMALE AETHEREUM (OLEUM ANIMALE)
OL-J ------> OLEUM JECORIS ASELLI
OL-SANT ------> OLEUM SANTALI
OLND ------> OLEANDER (NERIUM ODORUM)
ONIS ------> ONISCUS ASELLUS (MILLEPEDES)
ONOS ------> ONOSMODIUM VIRGINIANUM (ONOSMODIUM)
OP ------> OPIUM (PAPAVER SOMNIFERUM)
OPER ------> OPERCULINA TURPENTHUM (OPERCULINA TURPETHUM)
OPUN-F ------> OPUNTIA FICUS (OPUNTIA-FICUS INDICA)
OREO ------> OREODAPHNE CALIFORNICA (OREODAPHNE)
ORIG ------> ORIGANUM MAJORANA (ORIGANUM)
ORNI ------> ORNITHOGALUM UMBELLATUM
OSM ------> OSMIUM
OST ------> OSTRYA VIRGINICA
OV ------> OVININUM (OOPHORINUM)
OVI-P ------> OVI GALLINAE PELLICULA
OX-AC ------> OXALICUM ACIDUM
OXYD ------> OXYDENDRON ARBOREUM (OXYDENDRON - ANDROMEDA ARBOREA)
OXYT ------> OXYTROPIS LAMBERTI (OXYTROPIS)
PAEON ------> PAEONIA OFFICINALIS (PAEONIA)
PALL ------> PALLADIUM METALLICUM (PALLADIUM)
PAR ------> PARIS QUADRIFOLIA
PARAF ------> PARAFFINUM (PARAFFINE)
PAREIR ------> PAREIRA BRAVA (CHONDRODENDRON TOMENTOSUM)
PARTH ------> PARTHENIUM HYSTEROPHORUS (PARTHENIUM - ESCOBA AMARGO)
PASSI ------> PASSIFLORA INCARNATA
PEN ------> PENTHORUM SEDOIDES (PENTHORUM)
PERT ------> PERTUSSINUM (PERTUSSIN)
PETR ------> PETROLEUM
PETROS ------> PETROSELINUM SATIVUM (PETROSELINUM)
PH-AC ------> PHOSPHORICUM ACIDUM
PHASE ------> PHASEOLUS NANUS (PHASEOLUS)
PHEL ------> PHELLANDRIUM AQUATICUM (PHELLANDRIUM)
PHOS ------> PHOSPHORUS
PHYS ------> PHYSOSTIGMA VENENOSUM
PHYSAL ------> PHYSALIS ALKEKENGI (PHYSALIS - SOLANUM VESICARIUM)
PHYT ------> PHYTOLACCA DECANDRA (PHYTOLACCA)
PIC-AC ------> PICRICUM ACIDUM
PIN-S ------> PINUS SILVESTRIS
PIP-M ------> PIPER METHYSTICUM
PIP-N ------> PIPER NIGRUM
PITU-GL ------> PITUITARIA GLANDULA (PITUITARY GLAND)
PIX ------> PIX LIQUIDA
PLAN ------> PLANTAGO MAJOR
PLAT ------> PLATINUM METALLICUM (PLATINA)
PLATAN ------> PLATANUS OCCIDENTALIS
PLB ------> PLUMBUM METALLICUM
PODO ------> PODOPHYLLINUM (PODOPHYLLUM)
POLYG-H ------> POLYGONUM HYDROPIPEROIDES (POLYGONUM PUNCTATUM)
POLYP-P ------> POLYPORUS PINICOLA
POP ------> POPULUS TREMULOIDES
POP-C ------> POPULUS CANDICANS
PRIM-O ------> PRIMULA OBCONICA
PRIM-V ------> PRIMULA VERIS
PROP ------> PROPYLAMINUM (PROPYLAMIN - TRIMETHYLAMINUM)
PRUN ------> PRUNUS SPINOSA
PSOR ------> PSORINUM
PTEL ------> PTELEA TRIFOLIATA (PTELEA)
PULS ------> PULSATILLA PRATENSIS (PULSATILLA)
PULX ------> PULEX IRRITANS
PYROG ------> PYROGENIUM
QUAS ------> QUASSIA AMARA (QUASSIA - PICRAENA EXCELSA)
QUEB ------> QUEBRACHO (ASPIDOSPERMA)
QUERC ------> QUERCUS E GLANDIBUS (QUERCUS GLANDIUM SPIRITUS)
QUILL ------> QUILLAYA SAPONARIA
RAD-BR ------> RADIUM BROMATUM (RADIUM)
RAN-B ------> RANUNCULUS BULBOSUS
RAN-S ------> RANUNCULUS SCELERATUS
RAPH ------> RAPHANUS SATIVUS (RAPHANUS)
RAT ------> RATANHIA PERUVIANA (RATANHIA)
RHAM-CAL ------> RHAMNUS CALIFORNICA
RHEUM ------> RHEUM PALMATUM (RHEUM)
RHOD-F ------> RHODODENDRON FERRUGINEUM (RHODODENDRON)
RHODI ------> RHODIUM METALLICUM (RHODIUM)
RHUS-A ------> RHUS AROMATICA
RHUS-G ------> RHUS GLABRA
RHUS-T ------> RHUS TOXICODENDRON
RHUS-V ------> RHUS VENENATA
RIC ------> RICINUS COMMUNIS (RICINUS COMMUNIS - BOFAREIRA)
ROB ------> ROBINIA PSEUDACACIA (ROBINIA)
ROS-D ------> ROSA DAMASCENA
RUMX ------> RUMEX CRISPUS
RUTA ------> RUTA GRAVEOLENS
SABAD ------> SABADILLA
SABAL ------> SABAL SERRULATA
SABIN ------> SABINA
SACCH ------> SACCHARUM OFFICINALE (SUCROSE)
SAL-AC ------> SALICYLICUM ACIDUM
SAL-N ------> SALIX NIGRA
SALV ------> SALVIA OFFICINALIS
SAMB ------> SAMBUCUS NIGRA
SANG ------> SANGUINARIA CANADENSIS (SANGUINARIA)
SANGIN-N ------> SANGUINARINUM NITRICUM (SANGUINARINA NITRICA)
SANIC ------> SANICULA AQUA (SANICULA)
SANTIN ------> SANTONINUM
SAPO ------> SAPONARIA OFFICINALIS (SAPONARIA)
SARCOL-A ------> SARCOLACTICUM ACIDUM (SARCOLACTIC ACID)
SAROTH ------> SAROTHAMNUS SCOPARIUS (SPARTIUM SCOPARIUM - CYSTISUS SCOPARIUS)
SARR ------> SARRACENIA PURPUREA
SARS ------> SARSAPARILLA OFFICINALIS (SARSAPARILLA)
SCROPH-N ------> SCROPHULARIA NODOSA
SCUT ------> SCUTELLARIA LATERIFOLIA
SEC ------> SECALE CORNUTUM (CLAVICEPS PURPUREA)
SED-AC ------> SEDUM ACRE
SEL ------> SELENIUM METALLICUM (SELENIUM)
SEMP ------> SEMPERVIVUM TECTORUM
SENEC ------> SENECIO AUREUS
SENEG ------> SENEGA
SENN ------> SENNA
SEP ------> SEPIA OFFICINALIS (SEPIA)
SER-ANG ------> SERUM ANGUILLAE (SERUM ANGUILLAR ICHTHYOTOXIN)
SIL ------> SILICEA TERRA (SILICEA)
SILPHU ------> SILPHIUM LACINATUM (SILPHIUM)
SIN-N ------> SINAPIS NIGRA (BRASSICA NIGRA)
SKAT ------> SKATOLUM (SKATOL)
SKOOK ------> SKOOKUM CHUCK AQUA (SKOOKUM - CHUCK)
SOL-N ------> SOLANUM NIGRUM
SOLID ------> SOLIDAGO VIRGAUREA (SOLIDAGO VIRGA)
SPIG ------> SPIGELIA ANTHELMIA (SPIGELIA)
SPIRA ------> SPIRANTHES AUTUMNALIS (SPIRANTHES)
SPIRAE ------> SPIRAEA ULMARIA
SPONG ------> SPONGIA TOSTA
SQUIL ------> SQUILLA MARITIMA
STACH ------> STACHYS BETONICA (BETONICA)
STANN ------> STANNUM METALLICUM (STANNUM)
STAPH ------> STAPHYSAGRIA
STEL ------> STELLARIA MEDIA
STICT ------> STICTA PULMONARIA (STICTA)
STIGM ------> STIGMATA MAYDIS (ZEA)
STILL ------> STILLINGIA SILVATICA (STILLINGIA)
STRAM ------> STRAMONIUM
STRONT-C ------> STRONTIUM CARBONICUM (STRONTIA)
STROPH-H ------> STROPHANTHUS HISPIDUS
STRY ------> STRYCHNINUM PURUM (STRYCHNINUM)
STRY-P ------> STRYCHNINUM PHOSPHORICUM (STRYCHNIA PHOSPHORICA)
STRYCH-G ------> STRYCHNOS GAULTHERIANA (HOANG NAN)
SUCC ------> SUCCINUM
SUL-AC ------> SULPHURICUM ACIDUM
SUL-I ------> SULPHUR IODATUM
SULFON ------> SULFONALUM (SULFONAL)
SULO-AC ------> SULPHUROSUM ACIDUM
SULPH ------> SULPHUR
SUMB ------> SUMBULUS MOSCHATUS (SUMBUL - FERULA SUMBUL)
SYM-R ------> SYMPHORICARPUS RACEMOSUS (SYMPHORICARPUS RACEMOSA)
SYMPH ------> SYMPHYTUM OFFICINALE (SYMPHYTUM)
SYPH ------> SYPHILINUM
SYZYG ------> SYZYGIUM JAMBOLANUM
TAB ------> TABACUM
TANAC ------> TANACETUM VULGARE
TANN-AC ------> TANNICUM ACIDUM (TANNIC ACID)
TARAX ------> TARAXACUM OFFICINALE
TARENT ------> TARENTULA HISPANICA
TARENT-C ------> TARENTULA CUBENSIS
TART-AC ------> TARTARICUM ACIDUM
TAX ------> TAXUS BACCATA
TELL ------> TELLURIUM METALLICUM (TELLURIUM)
TER ------> TEREBINTHINIAE OLEUM (TEREBINTHINA)
TEUCR ------> TEUCRIUM MARUM VERUM (TEUCRIUM MARUM)
THAL-MET ------> THALLIUM METALLICUM (THALLIUM)
THEA ------> THEA CHINENSIS (THEA)
THER ------> THERIDION CURASSAVICUM (THERIDION)
THIOSIN ------> THIOSINAMINUM (RHODALLIN)
THLAS ------> THLASPI BURSA PASTORIS (CAPSELLA)
THUJ ------> THUJA OCCIDENTALIS
THYMOL ------> THYMOLUM (THYMOL)
THYMU ------> THYMUS SERPYLLUM
THYR ------> THYROIDINUM
TIL ------> TILIA EUROPAEA (TILIA EUROPA)
TITAN ------> TITANIUM METALLICUM (TITANIUM)
TONG ------> TONGO-DIPTERIX ODORATA (TONGO - DIPTRIX ODORATA)
TOR ------> TORULA CEREVISIAE
TRIB ------> TRIBULUS TERRESTRIS
TRIF-P ------> TRIFOLIUM PRATENSE
TRIL-P ------> TRILLIUM PENDULUM
TRINIT ------> TRINITROTOLUENUM (TRINITROTOLUENE)
TRIOS ------> TRIOSTEUM PERFOLIATUM
TRITIC ------> TRITICUM REPENS-AGROPYRON REPENS (TRITICUM)
TROM ------> TROMBIDIUM MUSCAE DOMESTICAE (TROMBIDIUM)
TUB ------> TUBERCULINUM
TUS-P ------> TUSSILAGO PETASITES
UPA ------> UPAS TIEUT (UPAS TIENTE)
URAN-N ------> URANIUM NITRICUM
UREA ------> UREA PURA (UREA)
URT-U ------> URTICA URENS
USN ------> USNEA BARBATA
UST ------> USTILAGO MAYDIS
UVA ------> UVA URSI
VAC ------> VACCININUM
VALER ------> VALERIANA OFFICINALIS (VALERIANA)
VANAD ------> VANADIUM METALLICUM (VANADIUM)
VANIL ------> VANILLA AROMATICA (VANILLA - PLANIFOLIA)
VARIO ------> VARIOLINUM
VERAT ------> VERATRUM ALBUM
VERAT-V ------> VERATRUM VIRIDE
VERB ------> VERBASCUM THAPSUS (VERBASCUM)
VERBE-U ------> VERBENA URTICAEFOLIA (VERBENA)
VESP ------> VESPA CRABRO
VIB ------> VIBURNUM OPULUS
VINC ------> VINCA MINOR
VIOL-O ------> VIOLA ODORATA
VIOL-T ------> VIOLA TRICOLOR
VIP ------> VIPERA BERUS (VIPERA)
VISC ------> VISCUM ALBUM
WYE ------> WYETHIA HELENOIDES (WYETHIA)
X-RAY ------> X-RAY
XAN ------> XANTOXYLUM FRAXINEUM (XANTHOXYLUM)
XERO ------> XEROPHYLLUM
YOHIM ------> YOHIMBINUM
YUC ------> YUCCA FILAMENTOSA
ZINC ------> ZINCUM METALLICUM (ZINC)
ZINC-VAL ------> ZINCUM VALERIANICUM (ZINCUM VALERIANUM)
ZING ------> ZINGIBER OFFICINALE (ZINGIBER)
ZIZ ------> ZIZIA AUREA (THASPIUM AUREUM - ZIZIA)