Abies Nigra ----- Abies. n.
Abrotanum ----- Abrot.
Absinthium ----- Absin.
Acalypha Indica ----- Acal.
Aceticum Acidum ----- Acet. ac.
Aconitum Napellus ----- Acon.
Actea Racemosa (Cimicifuga) ----- Act. r.
Actea Spicata ----- Act. sp.
Æsculus Glabra ----- Æsc. g.
Æsculus Hippocastanum ----- Æsc.
Æthusa Cynapium ----- Æth.
Agaricus Muscarius (Amanita) ----- Agar.
Agnus Castus ----- Agn.
Ailanthus Glandulosa ----- Ail.
Aletris Farinosa ----- Alet.
Allium Cepa (Cepa) ----- All. c.
Allium Sativum ----- All. s.
Aloe Socotrina ----- Aloe
Alumina (Argilla) ----- Alum.
Alumina Silicata ----- See Kaol. ----- Kaolin
Alumen ----- Alumn.
Ambra Grisea ----- Ambr.
Ammoniacum ----- Ammc.
Ammonium Benzoicum ----- Am. be.
Ammonium Bromidum ----- Am. br.
Ammonium Carbonicum ----- Am. c.
Ammonium Muriaticum ----- Am. m.
Amygdala Amara ----- Amyg.
Amylenum Nitrosum ----- Aml. ns.
Anacardium Occidentale ----- Anac. oc.
Anacardium Orientale ----- Anac.
Anagallis Arvensis ----- Anag.
Anantherum Muricatum ----- Anan.
Angustura ----- Ang.
Anisum Stellatum ----- See Ill. ----- Illicium Anisatum
Anthracinum ----- Anthraci.
Anthrokokali ----- Anthraco.
Antimonium Arsenitum ----- Ant. ar.
Antimonium Chloridum ----- Ant. chl.
Antimonium Crudum ----- Ant. c.
Antimonium Muriaticum ----- See Ant. chl. ----- Antimonium Chloridum
Antimonium Sulphuratum Auratum ----- Ant. s. aur.
Antimonium Tartaricum ----- Ant. t.
Aphis Chenopodii Glauci ----- Aphis.
Apis (Apis Mellifica) ----- Apis
Apocynum Cannabinum ----- Apoc.
Aranea Diadema ----- See Dia. ----- Diadema Aranea
Argentum Metallicum ----- Arg. m.
Argentum Nitricum ----- Arg. n.
Argilla ----- See Alum. ----- Alumina
Armoracea Sativa (Cochlearia) ----- Arm.
Arnica Montana (Radix) ----- Arn.
Arsenicum Album ----- Ars.
Arsenicum Hydrogenisatum ----- Ars. h.
Arsenicum Iodatum ----- Ars. i.
Arsenicum Metallicum ----- Ars. met.
Arsenicum Sulphuratum Flavum ----- Ars. s. f.
Arsenicum Sulphuratum Rubrum ----- Ars. s. r.
Artemisia Vulgaris ----- Art.
Arum Dracontium ----- Arum d.
Arum Maculatum ----- Arum m.
Arum Triphyllum ----- Arum t.
Arundo Mauritanica ----- Arund.
Asafœtida ----- Asaf.
Asarum Europæum ----- Asar.
Asclepias Cornuti ----- See Asc. s. ----- Asclepias Syriaca
Asclepias Syriaca (Asclepias Cornuti) ----- Asc. s.
Asclepias Tuberosa ----- Asc. t.
Asimina Triloba ----- Asim.
Asparagus Officinalis ----- Aspar.
Astacus Fluviatilis ----- Astac.
Asterias Rubens ----- Aster.
Atropinum ----- Atro.
Atropinum Sulphuricum ----- Atro. s.
Aurantium (Citrus Vulgaris) ----- Aurant.
Aurum Metallicum ----- Aur.
Aurum Muriaticum ----- Aur. m.
Aurum Muriaticum Natronatum ----- Aur. m. n.
Badiaga ----- Bad.
Baptisia Tinctoria ----- Bapt.
Baryta Carbonica ----- Bar. c.
Baryta Muriatica ----- Bar. m.
Belladonna ----- Bell.
Benzoic Acid ----- Benz. ac.
Berberis (Berberis Vulgaris) ----- Berb.
Bismuthum ----- Bism.
Boletus Laricis ----- See Polyp. ----- Polyporus Officinalis
Borax (Borax Veneta) ----- Bor.
Bovista ----- Bov.
Brachyglottis Repens ----- Brach.
Bromium ----- Brom.
Bryonia Alba ----- Bry.
Bufo Rana (Bufones) ----- Bufo
Bufones ----- See Bufo ----- Bufo Rana
Bursa Pastoris ----- See Thlas. ----- Thlaspi Bursa Pastoris
Cactus Grandiflorus ----- Cact.
Cadmium Sulfuratum ----- Cadm. s.
Cahinca Racemosa ----- See Cain. ----- Cainca
Cainca (Cahinca Racemosa) ----- Cain.
Cajeputi ----- See Ol. c. ----- Oleum Cajeputi
Calabar ----- Calab. (See  also : Physostigma **)
Caladium Seguinum ----- Calad.
Calcarea Arsenica ----- Calc. ar.
Calcarea Carbonica ----- See Calc. ostr. ----- Calcarea Ostrearum
Calcarea Fluorica ----- Calc. f.
Calcarea Ostrearum (Calcarea Carbonica) ----- Calc. ostr.
Calcarea Phosphorica ----- Calc. p.
Calcarea Sulphurica ----- Calc. s.
Calendula ----- Calen.
Camphora ----- Camph.
Cannabis Indica ----- Cann. i.
Cannabis Sativa ----- Cann. s.
Cantharides (Cantharis Vesicatoria) ----- Canth.
Cantharis Vesicatoria ----- See Canth. ----- Cantharides
Capsicum (Capsicum Annuum) ----- Caps.
Carbo Animalis ----- Carb. an.
Carbo Vegetabilis ----- Carb. v.
Carbolicum Acid ----- Carb. ac.
Carboneum Sulphuratum ----- Carbn. s.
Carduus Marianus ----- Card. m.
Cascarilla ----- Casc.
Castanea Vesca ----- Cast. v.
Castor Equorum (Castor Equi) ----- Cast. eq.
Castoreum (Castoreum Canadense) ----- Cast.
Caulophyllum Thalictroides ----- Caul.
Causticum ----- Caust.
Ceanothus Americanus ----- Cean.
Cedron ----- Cedr.
Cepa ----- See All. c. ----- Allium Cepa
Cetraria Islandica ----- Cetr.
Chamomilla ----- Cham.
Chelidonium Majus ----- Chel.
Chenopodii Glauci Aphis ----- See Aphis. ----- Aphis Chenopodii Glauci
Chenopodium Anthelminticum ----- Chen. a.
Chenopodium Vulvaria ----- Chen. v.
Chimaphila Maculata ----- Chim. m.
Chimaphila Umbellata ----- Chim.
China (Cinchona) Boliviana ----- Chin. b.
China (Cinchona) Officinalis ----- Chin.
Chininum Arsenicosum ----- Chin. ar.
Chininum Muriaticum ----- Chin. m.
Chininum Sulphuricum ----- Chin. s.
Chionanthus Virginica ----- Chion.
Chloralum ----- Chlol.
Chloroformum ----- Chlf.
Chlorum ----- Chlor.
Chromicum Acidum ----- Chr. ac.
Cicuta Virosa ----- Cic.
Cimex Lectularius ----- Cimx.
Cimicifuga ----- See Act. r. ----- Actea Racemosa
Cina (Cina Maritima) ----- Cina
Cinchona ----- See Chin. ----- China Officinalis
Cinnabaris ----- Cinnb.
Cinnamomum ----- Cinnm.
Cistus Canadensis ----- Cist.
Citrus Limonum ----- Cit. l.
Citrus Vulgaris ----- See Aurant. ----- Aurantium
Clematis Erecta ----- Clem.
Cobaltum Metallicum ----- See Kobalt. ----- Kobaltum
Coca (Erythroxylon Coca) ----- Coca
Coccinella Septempunctata ----- Cocc. s.
Cocculus (Cocculus Indicus) ----- Cocc.
Coccus Cacti ----- Coc. c.
Cochlearia (Armoracea Sativa) ----- See Arm. ----- Armoracea Sativa
Codeinum ----- Cod.
Coffea Cruda ----- Coff.
Coffea Tosta ----- Coff. t.
Colchicum Autumnale ----- Colch.
Collinsonia Canadensis ----- Coll.
Colocynthis ----- Coloc.
Comocladia Dentata ----- Com.
Conium Maculatum ----- Con.
Copaiva ----- Cop.
Corallium Rubrum ----- Cor. r.
Cornus Circinata and Florida ----- Corn.
Creosote ----- See Kreos. ----- Kreosotum
Crocus Sativus ----- Croc.
Crotalus Horridus ----- Crot. h.
Croton Tiglium ----- Crot. t.
Cubeba (Cubeba Officinalis) ----- Cub.
Cundurango ----- Cund.
Cuprum Aceticum ----- Cupr. a.
Cuprum Arsenicosum ----- Cupr. ar.
Cuprum Metallicum ----- Cupr.
Cuprum Sulphuricum ----- Cupr. s.
Curare (Curara) ----- Cur.
Cyclamen Europæum ----- Cycl.
Cypripedium (Cypripedium Pubescens) ----- Cypr.
Daphne Indica ----- See Daph. ----- Daphne Odora
Daphne Odora (Daphne Indica) ----- Daph.
Diadema Aranea (Aranea Diadema) ----- Dia.
Digitalis Purpurea ----- Dig.
Dioscorea Villosa ----- Dios.
Dolichos Pruriens ----- Dol.
Doryphora Decemlineata ----- Dor.
Drosera Rotundifolia ----- Dros.
Dulcamara ----- Dulc.
Elaps Corallinus ----- Elaps
Elaterium (Elaterium Officinarum) ----- Elat.
Equisetum Hyemale ----- Equis.
Erigeron (Erigeron Canadense) ----- Erig.
Eryngium Aquaticum ----- Ery. a.
Erythroxylon Coca ----- See Coca ----- Coca
Eucalyptus Globulus ----- Eucal.
Eugenia Jambos ----- See Jamb. ----- Jambos Eugenia
Euphorbium (Euphorbium Officinarum) ----- Euph.
Euphrasia (Euphrasia Officinalis) ----- Euphr.
Eupatorium Perfoliatum ----- Eup. per.
Eupatorium Purpureum ----- Eup. pur.
Ferrum (Ferrum Metallicum) ----- Ferr.
Ferrum Iodatum ----- Ferr. i.
Ferrum Muriaticum ----- Ferr. m.
Ferrum Phosphoricum ----- Ferr. p.
Ferrum Sulphuricum ----- Ferr. s.
Filix Mas ----- Fil.
Fluoricum Acidum ----- Fl. ac.
Formica Rufa ----- Form.
Gambogia (Gummi Gutti) ----- Gamb.
Gelsemium (Gelsemium Sempervirens) ----- Gels.
Glonoinum ----- Glon.
Gnaphalium Polycephalum ----- Gnaph.
Gossypium Herbaceum ----- Goss.
Graphites ----- Graph.
Gratiola Officinalis ----- Grat.
Grindelia Robusta ----- Grin.
Guaiacum (Guajacum Officinale) ----- Guaj.
Guarana ----- Guar.
Guarea Trichilioides ----- Guare.
Gummi Gutti ----- See Gamb. ----- Gambogia
Gymnocladus Canadensis ----- Gymno.
Hamamelis Virginica (Hamamelis Virginiana) ----- Ham.
Hecla Lava (Hekla lava) ----- Hecla
Helleborus (Helleborus Niger) ----- Hell.
Helonias Dioica ----- Helon.
Hepar Sulph. Calc. (Hepar Sulphuris Calcareum) ----- Hep.
Hippomanes ----- Hipp.
Hippozænin (Hippozæninum) ----- Hippoz.
Hydrastis Canadensis ----- Hydr.
Hydrocotyle Asiatica ----- Hydrc.
Hydrocyanic Acid (Hydrocyanicum Acidum) ----- Hydr. ac.
Hydrophobinum ----- See Lyss. ----- Lyssin
Hyoscyamus Niger ----- Hyos.
Hypericum Perforatum ----- Hyper.
Iberis Amara ----- Iber.
Ictodes Fœtida ----- Ictod.
Ignatia (Ignatia Amara) ----- Ign.
Illicium anisatum ----- Ill.
Indigo (Indigo Tinctoria) ----- Indg.
Indium Metallicum ----- Ind.
Inula (Inula Helenium) ----- Inul.
Iodoformum (Iodoformium) ----- Iodof.
Iodum (Iodium Purum) ----- Iod.
Ipecacuanha ----- Ip.
Ipomœa ----- Ipom.
Iridium (Iridium Metallicum) ----- Irid.
Iris Versicolor ----- Iris
Jaborandi ----- Jab.
Jacaranda Caroba ----- Jac. c.
Jacea (Viola Tricolor) ----- Jac.
Jalapa ----- Jal.
Jambos Eugenia (Eugenia Jambos) ----- Jamb.
Jatropha (Jatropha Curcas) ----- Jatr.
Juglans Cinerea ----- Jug. c.
Kali Arsenicosum ----- Kali ar.
Kali Bichromicum ----- Kali bi.
Kali Bromatum ----- Kali br.
Kali Carbonicum ----- Kali c.
Kali Cyanatum ----- Kali cy.
Kali Ferrocyanatum ----- Kali fcy.
Kali Hydriodicum ----- See Kali i. -----Kali Iodatum
Kali Iodatum (Kali Hydriodicum) ----- Kali i.
Kali Muriaticum ----- Kali m.
Kali Nitricum (Nitrum) ----- Kali n.
Kali Permanganicum ----- Kali perm.
Kali Phosphoricum ----- Kali p.
Kali Sulphuricum ----- Kali s.
Kalmia Latifolia ----- Kalm.
Kaolin (Alumina silicata) ----- Kaol.
Kobaltum (Cobaltum Metallicum) ----- Kobalt.
Kreosotum (Creosote) ----- Kreos.
Lac Caninum ----- Lac c.
Lac Vaccinum Defloratum ----- Lac d.
Lachesis (Lachesis Mutus) ----- Lach.
Lachnanthes Tinctoria ----- Lachn.
Lactic Acid (Lacticum Acidum) ----- Lac. ac.
Lactuca Virosa ----- Lact.
Lapis Albus ----- Lap. a.
Laurocerasus ----- Laur.
Ledum Palustre ----- Led.
Leptandra (Leptandra Virginica) ----- Lept.
Lilium Tigrinum ----- Lil. t.
Lithium Carbonicum ----- Lith. c.
Lobelia Cœrulea (Lobelia Syphilitica) ----- Lob. c.
Lobelia Inflata ----- Lob.
Lobelia Syphilitica ----- See Lob. c. ----- Lobelia Cœrulea
Luesinum ----- See Syph. ----- Syphilinum
Lycopodium (Lycopodium Clavatum) ----- Lyc.
Lycopus virginicus ----- Lycps.
Lyssin (Lyssinum) (Hydrophobinum) ----- Lyss.
Magnesia Carbonica ----- Mag. c.
Magnesia Muriatica ----- Mag. m.
Magnesia Phosphorica ----- Mag. p.
Magnesia Sulphurica ----- Mag. s.
Mancinella ----- Manc.
Manganum (Manganum Aceticum) ----- Mang.
Marum Verum (Teucrium) ----- Mar. v.
Medorrhinum ----- Med.
Melilotus (Melilotus Officinalis) ----- Meli.
Menyanthes Trifoliata ----- Meny.
Mephitis Putorius ----- Meph.
Mercurialis Perennis ----- Merl.
Mercurius (Mercurius Solubilis et Vivus) ----- Merc.
Mercurius Corrosivus ----- Merc. c.
Mercurius Cyanatus ----- Merc. cy.
Mercurius Dulcis ----- Merc. d.
Mercurius Iodatus Flavus ----- Merc. i. f.
Mercurius Iodatus Ruber ----- Merc. i. r.
Mercurius Solubilis ----- See Merc. ----- Mercurius
Mercurius Sulphuricus (Turpethum) ----- Merc. sul.
Mercurius Vivus ----- See Merc. ----- Mercurius
Mezereum ----- Mez.
Millefolium ----- Mill.
Mitchella Repens ----- Mit.
Morphinum Sulphuricum ----- Morph.
Moschus ----- Mosch.
Murex Purpurea ----- Murx.
Muriaticum Acidum ----- Mur. ac.
Mygale (Mygale Lasiodora) ----- Mygal.
Myosotis (Myosotis Arvensis) ----- Myos. a.
Myrica Cerifera ----- Myric.
Myrtus Communis ----- Myrt. c.
Naja Tripudians ----- Naja
Natrum Arsenicatum ----- Nat. ar.
Natrum Carbonicum ----- Nat. c.
Natrum Muriaticum ----- Nat. m.
Natrum Phosphoricum ----- Nat. p.
Natrum Sulphuricum ----- Nat. s.
Niccolum ----- Nicc.
Nitri Spiritus Dulcis ----- Nit. s. d.
Nitric Acid (Nitric Acidum) ----- Nit. ac.
Nitrum ----- See Kali n. ----- Kali Nitricum
Nuphar Luteum ----- Nuph.
Nux Moschata ----- Nux. m.
Nux Vomica ----- Nux. v.
Œnanthe Crocata ----- Œna.
Oleander ----- Olnd.
Oleum Animale (Oleum Animale Æthereum) ----- Ol. an.
Oleum Cajeputi (Cajeputi) ----- Ol. c.
Oleum Jecoris Aselli ----- Ol. j.
Opium ----- Op.
Origanum (Origanum Majorana) ----- Orig.
Osmium (Osmium Metallicum) ----- Osm.
Oxalicum Acidum ----- Ox. ac.
Pæonia (Pæonia Officinalis) ----- Pæon.
Palladium (Palladium Metallicum) ----- Pall.
Pareira Brava ----- Pareir.
Paris Quadrifolia ----- Par.
Petroleum ----- Petr.
Petroselinum (Petroselinum Sativum) ----- Petros.
Phellandrium (Phellandrium Aquaticum) ----- Phel.
Phosphoricum Acidum ----- Ph. ac.
Phosphorus ----- Phos.
Physostigma (Physostigma Venenosum) ----- Phys. (See also : Calabar **)
Phytolacca (Phytolacca Decandra) ----- Phyt.
Picric Acid (Picricum Acidum) ----- Pic. ac.
Pix Liquida ----- Pix
Plantago Major ----- Plan.
Platinum (Platinum Metallicum) ----- Plat.
Plumbum (Plumbum Metallicum) ----- Plb.
Podophyllum Peltatum ----- Podo.
Polygonum (Polygonum Hydropiperoides) ----- Polyg. h.
Polyporus Officinalis (Boletus Laricis) ----- Polyp.
Prunus Spinosa ----- Prun.
Psorinum ----- Psor.
Ptelea Trifoliata ----- Ptel.
Pulsatilla (Pulsatilla Pratensis) ----- Puls.
Ranunculus Bulbosus ----- Ran. b.
Ranunculus Sceleratus ----- Ran. s.
Raphanus Sativus ----- Raph.
Ratanhia (Ratanhia Peruviana) ----- Rat.
Rheum (Rheum Palmatum) ----- Rheum
Rhododendron (Rhododendron Chrysanthum) ----- Rhod.
Rhus Toxicodendron ----- Rhus t.
Rhus Venenata (Rhus Vernix) ----- Rhus v.
Rhus Vernix ----- See Rhus v. ----- Rhus Venenata
Robinia ----- Rob.
Rumex Crispus ----- Rumx.
Ruta Graveolens ----- Ruta
Sabadilla ----- Sabad.
Sabina ----- Sabin.
Salicylicum Acidum ----- Sal. ac.
Sambucus Nigra ----- Samb.
Sanguinaria Canadensis ----- Sang.
Sarracenia Purpurea ----- Sarr.
Sarsaparilla (Sarsaparilla Officinalis) ----- Sars.
Secale Cornutum ----- Sec.
Selenium (Selenium Metallicum) ----- Sel.
Senecio (Senecio Aureus) ----- Senec.
Senega ----- Seneg.
Sepia (Sepia Officinalis) ----- Sep.
Silicea (Silicea Terra) ----- Sil.
Sinapis Alba ----- Sin. a.
Sinapis Nigra ----- Sin. n.
Spigelia (Spigelia Anthelmia) ----- Spig.
Spongia Tosta ----- Spong.
Squilla (Squilla Maritima) ----- Squil.
Stannum (Stannum Metallicum) ----- Stann.
Staphisagria ----- Staph.
Sticta Pulmonaria ----- Stict.
Stillingia Sylvatica ----- Still.
Stramonium ----- Stram.
Strontiana Carbonica ----- Stront. c.
Sulphur ----- Sulph.
Sulphuricum Acidum ----- Sul. ac.
Sumbul (Sumbulus Moschatus) ----- Sumb.
Symphytum (Symphytum Officinale) ----- Symph.
Syphilinum (Luesinum) ----- Syph.
Tabacum ----- Tab.
Taraxacum (Taraxacum Officinale) ----- Tarax.
Tarentula (Tarentula Hispanica) ----- Tarent.
Tellurium (Tellurium Metallicum) ----- Tell.
Terebinthina (Terebinthiniæ Oleum) ----- Ter.
Teucrium ----- See Mar. v. ----- Marum Verum
Theridion Curassavicum ----- Ther.
Thlaspi Bursa Pastoris (Bursa Pastoris) ----- Thlas.
Thuja (Thuja Occidentalis) ----- Thuj.
Trillium Pendulum ----- Tril.
Trombidium (Trombidium Muscæ Domesticæ) ----- Trom.
Tuberculinum (Tuberculinum Bovinum) ----- Tub.
Turpethum ----- See Merc. Sul. ----- Mercurius Sulphuricus
Uranium Nitricum ----- Uran. n.
Urtica Urens ----- Urt. u.
Ustilago (Ustilago Maydis) ----- Ust.
Uva Ursi ----- Uva
Vaccininum and Variolinum ----- Vac.
Valeriana (Valeriana Officinalis) ----- Valer.
Variolinum and Vaccininum ----- Var.
Veratrum Album ----- Verat.
Veratrum Viride ----- Verat. v.
Verbascum Thapsus ----- Verb.
Vespa (Vespa Crabro) ----- Vesp.
Viburnum Opulus ----- Vib.
Vinca Minor ----- Vinc.
Viola Odorata ----- Viol. o.
Viola Tricolor ----- See Jac. ----- Jacea
Xan.
Zincum (Zincum Metallicum) ----- Zinc.
Zingiber (Zingiber Officinale) ----- Zing.
Zizia (Zizia Aurea) ----- Ziz.