Abies Canadensis ----- Ab. c.
Abies Nigra ----- Ab. n.
Abrotanum ----- Abrot.
Abrus precatorius ----- (see Jequirity) ----- Jeq.
Absinthium ----- Absinth.
Acalypha Indica ----- Acal.
Acetanilidum ----- (see Antifebrinum) ----- Antifeb.
Aceticum Acidum ----- Acet. ac.
Aconitinum ----- Aconitin.
Aconitum Cammarum ----- A. camm.
Aconitum Ferox ----- A. ferox
Aconitum Lycoctonum ----- A. lycoct.
Aconitum Napellus ----- Acon.
Actæa Racemosa ----- Act. r.
Actæa Spicata ----- Act. sp.
Adonis Vernalis ----- Adonis
Adrenalin ----- Adrenalin
Æsculus Glabra ----- Æsc. g.
Æsculus Hippocastanum ----- Æsc. hip.
Æthiops Antimonialis ----- Æthiops ant.
Æthusa Cynapium ----- Æthus.
Agaricus Emeticus ----- Agar. emet.
Agaricus Muscarius ----- Agar.
Agaricus Phalloides ----- Agar. phal.
Agave Americana ----- Agave
Agnus Castus ----- Agn. c.
Agraphis Nutans ----- Agraphis
Agrostema Githago ----- Agros.
Ailanthus Glandulosa ----- Ailanth.
Aletris Farinosa ----- Alet. far.
Allium Cepa ----- All. cep.
Allium Sativum ----- All. sat.
Alnus ----- Alnus
Aloe Socotrina ----- Aloe
Alstonia Constricta ----- Alston. c.
Alumen ----- Alum.
Alumina ----- Alm.
Ambra Grisea ----- Ambra
Ambrosia Artemisiæfolia ----- Ambro.
Ammoniacum ----- Ammon.
Ammonium Aceticum ----- Amm. acet.
Ammonium Benzoicum ----- Amm. benz.
Ammonium Bromatum ----- Amm. bro.
Ammonium Carbonicum ----- Amm. carb.
Ammonium Causticum ----- Amm. caust.
Ammonium Muriaticum ----- Amm. mur.
Ammonium Phosphoricum ----- Amm. phos.
Ammonium Picricum ----- Amm. pic.
Ampelopsis ----- Ampel.
Amphisbæna ----- Amph.
Amygdalæ Amaræ Aqua ----- Amyg.
Amylenum Nitrosum ----- Amyl. nit.
Anacardium Occidentale ----- Anac. occ.
Anacardium Orientale ----- Anac.
Anagallis Arvensis ----- Anag.
Anatherum Muricatum ----- Anath.
Ancistroden Contortrix ----- (see Cenchris Contortrix) ----- Cench.
Angophora ----- Angoph.
Angustura Vera ----- Angust.
Angustura Spuria ----- (see Brucea Antidysenterica) ----- Brucea
Anhalonium Lewinii ----- Anhal.
Anilinum ----- Anil.
Anisum Stellatum ----- (see Illicium) ----- Illic.
Anthemis Nobilis ----- Anthem. nob.
Anthoxanthum ----- Anthox.
Anthracinum ----- Anthrac.
Anthrokokali ----- Anthro.
Antifebrinum ----- Antifeb.
Antimonium Arsenicicum ----- Antim. ars.
Antimonium Crudum ----- Antim. crud.
Antimonium Iodatum ----- Antim. iod.
Antimonium Muriaticum ----- Antim. mur.
Antimonium Sulphuratum Aureum ----- Antim. sul. aur.
Antimonium Tartaricum ----- Antim. tart.
Antipyrinum ----- Antipyrin.
Aphis Chenopodii Glauci ----- Aphis
Apis ----- Apis
Apium Graveolens ----- Apium g.
Apocynum Androsæmifolium ----- Apoc. andr.
Apocynum Cannabinum ----- Apoc. c.
Apomorphinum ----- Apomorph.
Aqua Marina ----- Aq. mar.
Aquilegia Vulgaris ----- Aquil.
Aralia Racemosa ----- Aralia
Aranea Diadema ----- Aran. d.
Aranearum Tela ----- Aran. t.
Aranea Scinencia ----- Aran. scin.
Arbutus Andrachne ----- Arbutus
Arctium Lappa ----- Arct.
Areca ----- Areca nut
Argentum Cyanatum ----- Arg. cy.
Argentum Iodatum ----- Arg. iod.
Argentum Metallicum ----- Arg.
Argentum Nitricum ----- Arg. n.
Aristolochia Milhomens ----- Arist. m.
Aristolochia Serpentaria ----- Arist. serp.
Armoracia Sativa ----- Armor. sat.
Arnica ----- Arn.
Arsenicum Album ----- Ars.
Arsenicum Bromatum ----- Ars bro.
Arsenicum Hydrogenisatum ----- Ars. hydro.
Arsenicum Iodatum ----- Ars. iod.
Arsenicum Metallicum ----- Ars. m.
Arsenicum Stibiatum ----- (see Antimonium Arsenicicum) ----- Antim. ars.
Arsenicum Sulphuratum Flavum ----- Ars. s. f.
Arsenicum Sulphuratum Rubrum ----- Ars. s. r.
Artemisia Abrotanum ----- (see Abrotanum) ----- Abrot.
Artemisia Absinthium ----- (see Absinthium) ----- Absinth.
Artemisia Contra and Judaica ----- (see Cina) ----- Cina
Artemisia Vulgaris ----- Artem. v.
Arum Dracontium ----- Arum dracont.
Arum Dracunculus ----- Arum dracun.
Arum Italicum ----- Arum i.
Arum Maculatum ----- Arum. m.
Arum Triphyllum ----- Arum. tri.
Arundo Mauritanica ----- Arundo
Asafœtida ----- Asaf.
Asarum Europœum ----- Asar.
Asclepias Syriaca ----- Asclep. syr.
Asclepias Tuberosa ----- Asclep. tub.
Asimina Triloba ----- Asimina
Asparagus ----- Aspar.
Astacus Fluviatilis ----- Astacus
Asterias Rubens ----- Aster. r.
Astragalus Menziesii ----- Astrag.
Athamanta ----- Atham.
Atropinum ----- Atrop.
Aurantium ----- Aurant.
Aurum Arsenicicum ----- Aur. ars.
Aurum Bromatum ----- Aur. bro.
Aurum Iodatum ----- Aur. iod.
Aurum Metallicum ----- Aur.
Aurum Muriaticum ----- Aur. mur.
Aurum Muriaticum Kalinatum ----- Aur. mur. kal.
Aurum Muriaticum Natronatum ----- Aur. mur. nat.
Aurum Sulphuratum ----- Aur. sul.
Avena Sativa ----- Avena
Aviaire ----- Aviaire
Azadirachta Indica ----- Azad.
Bacillinum ----- Bac.
Bacillinum Testium ----- Bac. test.
Badiaga ----- Bad.
Balsamum Peruvianum ----- Bals.
Baptisia Confusa Acetica ----- Bapt. c. acet.
Baptisia Tinctoria ----- Bapt.
Barosma ----- Barosma
Baryta Acetica ----- (see Baryta Carbonica) ----- Bar. carb.
Baryta Carbonica ----- Bar. carb.
Baryta Iodata ----- Bar. iod.
Baryta Muriatica ----- Bar. mur.
Belladonna ----- Bell.
Bellis Perennis ----- Bellis
Benzinum ----- Benz.
Benzinum Dinitricum ----- Benz. dinit.
Benzinum Nitricum ----- Benz. nit.
Benzoicum Acidum ----- Benz. ac.
Benzoin ----- Benzoin
Berberis Aquifolium ----- Berb. aqui.
Berberis Vulgaris ----- Berb. vulg.
Bismuthum ----- Bism.
Blatta Americana ----- Blatt. amer.
Blatta Orientalis ----- Blatt. orient.
Boletus Laricis ----- Bol. lar.
Boletus Luridus ----- Bol. lur.
Boletus Satanas ----- Bol. sat.
Bombyx Processionea ----- Bomb.
Boracicum Acidum ----- Bor. ac.
Borax ----- Borax
Bothrops Lanceolatus ----- Bothrops
Bovista ----- Bov.
Brachyglottis Repens ----- Brach.
Brassica Napus ----- Bras.
Bromium ----- Brom.
Brucea Antidysenterica ----- Brucea
Brucinum ----- Brucinum
Bryonia ----- Bry
Buchu ----- (see Barosma) ----- Barosma
Bufo ----- Buf.
Bursa Pastoris ----- (see Thlaspi Bursa Pastoris) ----- Thlasp.
Cactus Grandiflorus ----- Cact.
Cadmium Bromatum ----- Cad. br.
Cadmium Sulphuratum ----- Cad. s.
Cainca ----- Cainca
Cajuputum ----- Caj.
Calabar ----- (see Physostigma) ----- Physo.
Caladium ----- Calad.
Calcarea Acetica ----- Calc. ac.
Calcarea Arsenicosa ----- Calc. ars.
Calcarea Bromata ----- Calc. bro.
Calcarea Carbonica ----- Calc.
Calcarea Caustica ----- Calc. caust.
Calcarea Chlorinata ----- Calc. chl.
Calcarea Fluorata ----- Calc. fluor.
Calcarea Hypophosphorosa ----- Calc. hyp.
Calcarea Iodata ----- Calc. iod.
Calcarea Lactica ----- Calc. lact.
Calcarea Lactica Natronata ----- Calc. lact. nat.
Calcarea Muriatica ----- Calc. mur.
Calcarea Ovi Testæ ----- Calc. ov. test.
Calcarea Oxalica ----- Calc. ox.
Calcarea Phosphorica ----- Calc. phos.
Calcarea Picrica ----- Calc. pic.
Calcarea Renalis ----- Calc. ren.
Calcarea Silicica ----- Calc. sil.
Calcarea Silico-fluorica ----- (see Lapis Albus) ----- Lap. a.
Calcarea Sulphurica ----- Calc. sulph.
Calendula ----- Calen.
Calotropis ----- Calo.
Caltha Palustris ----- Calth. p.
Camphora ----- Camph.
Camphora Bromata ----- Camph. bro.
Cancer Fluviatilis ----- (see Astacus Fluviatilis) ----- Astacus
Canchalagua ----- Canch.
Cannabis Indica ----- Can. ind.
Cannabis Sativa ----- Can. sat.
Cantharis ----- Canth.
Capsicum ----- Caps.
Carbo Animalis ----- Carb. an.
Carbo Vegetabilis ----- Carb. veg.
Carbolicum Acidum ----- Carbol. ac.
Carboneum ----- Carb.
Carboneum Hydrogenisatum ----- Carbo. h.
Carboneum Oxygenisatum ----- Carbo. ox.
Carboneum Sulphuratum ----- Carbo. sul.
Carcinosinum ----- Carcin
Carduus Benedictus ----- Card. ben.
Carduus Marianus ----- Card. m.
Carlsbad ----- Carlsb.
Carya Alba ----- Carya
Cascara Sagrada ----- Casc. sagr.
Cascarilla ----- Cascari.
Castanea Vesca ----- Castan.
Castor Equi ----- Cast. eq.
Castoreum ----- Cast.
Caulophyllum ----- Caulo.
Causticum ----- Caust.
Ceanothus Americanus ----- Cean.
Cedron ----- Cedr.
Cenchris Contortrix ----- Cench.
Centaurea Tagana ----- Cent. t.
Cereus Bonplandii ----- Cer. bon.
Cereus Serpentinus ----- Cer. s.
Cerium Oxalicum ----- Cer. ox.
Cervus ----- Cervus
Cetraria Islandica ----- Cetraria
Chamomilla ----- Cham.
Chaparro Amargoso ----- Chapar.
Cheiranthus Cheiri ----- Cheiranth.
Chelidonium ----- Chel.
Chelone ----- Chelone
Chenopodium Anthelminticum ----- Chen. anth.
Chenopodium Vulvaria ----- Chen. v.
Chimaphila Maculata ----- Chim. mac.
Chimaphila Umbellata ----- Chim. umb.
China Boliviana ----- China bol.
China Officinalis ----- China.
Chininum Arsenicosum ----- Chi. ars.
Chininum Muriaticum ----- Chi. mur.
Chininum Salicylicum ----- Chi. sal.
Chininum Sulphuricum ----- Chi. sul.
Chionanthus Virginica ----- Chion.
Chloralum ----- Chloral.
Chloroformum ----- Chlorof.
Chlorum ----- Chlorum
Cholesterinum ----- Cholest.
Chromicum Acidum & Chromium Oxidatum ----- Chromic.
Chromium Kali Sulphuratum ----- Cr. k. s.
Chrysophanicum Acidum ----- Chry. ac.
Cichorium ----- Cich.
Cicuta Maculata ----- Cic. m.
Cicuta Virosa ----- Cic. v.
Cimex ----- Cimex
Cina ----- Cina
Cinchoninum Sulphuricum ----- Cinch. s.
Cineraria Maritima ----- Ciner.
Cinnabaris ----- Cinnab.
Cinnamomum ----- Cinnam.
Cistus Canadensis ----- Cistus
Citrus Limonum ----- Citrus
Citrus Vulgaris ----- (see Aurantium) ----- Aurant.
Clematis Erecta ----- Clem.
Cobaltum ----- Cobalt.
Coca ----- Coca
Coccinella Septempunctata ----- Coccin.
Cocculus Indicus ----- Coccul.
Coccus Cacti ----- Coc. c.
Cochlearia Armoracia ----- (see Armoracia Sativa) ----- Armor. sat.
Codeinum ----- Codein.
Coffea Cruda ----- Coff. c.
Coffea Tosta ----- Coff. t.
Coffeinum ----- Coffein.
Colchicinum ----- Colchn.
Colchicum ----- Colch.
Collinsonia Canadensis ----- Collins.
Colocynthinum ----- Colocynth.
Colocynthis ----- Coloc.
Colostrum ----- Colost.
Comocladia ----- Comocl.
Conchiolinum ----- Conch.
Coniinum ----- Coniin.
Coniinum Bromatum ----- Coniin. bro.
Conium Maculatum ----- Conium
Convallaria Majalis ----- Conval.
Convolvulus Arvensis ----- Conv. a.
Convolvulus Duartinus ----- Conv. d.
Copaiva ----- Copaiva
Coqueluchinum ----- Coqueluchin.
Corallium Rubrum ----- Coral.
Coriaria Ruscifolia ----- Coria.
Cornus Alternifolia ----- Corn. a.
Cornus Circinata ----- Corn. c.
Cornus Florida ----- Corn. f.
Corydalis ----- Coryd.
Coto Bark ----- Coto b.
Cotyledon ----- Cotyl.
Cratægus Oxyacantha ----- Cratæg.
Crocus Sativus ----- Croc.
Crotalus Cascavella ----- Crot. c.
Crotalus Horridus ----- Crot. h.
Croton Chloral ----- Croton chl.
Croton Tiglium ----- Croton tig.
Cubeba ----- Cubeba
Cucurbita Pepo ----- Cucurb. p.
Culex Musca ----- Culex
Cundurango ----- Cundur.
Cuphea Viscosissima ----- Cuphea
Cupressus Australis ----- Cupress. aust.
Cupressus Lawsoniana ----- Cupress. l.
Cuprum Aceticum ----- Cupr. acet.
Cuprum Arsenicosum ----- Cupr. ars.
Cuprum Metallicum ----- Cupr.
Cuprum Sulphuricum ----- Cupr. sul.
Curare ----- Cur.
Cyclamen ----- Cycl.
Cynosbati ----- (see Rosa Canina) ----- Rosa can.
Cypripedium ----- Cypr.
Damiana ----- (see Turnera Aphrodisiaca) ----- Turn. a.
Daphne Indica ----- Daph. ind.
Datura Arborea ----- Datur. a.
Datura Ferox ----- Datur fer.
Datura Metel ----- Datur. met.
Derris Pinnata ----- Der.
Diadema ----- (see Aranea) ----- Aran. d.
Dictamnus ----- Dict.
Digitalinum ----- Dgn.
Digitalis ----- Digital.
Digitoxinum ----- Digitox.
Dioscorea ----- Diosc.
Diphtherinum ----- Diph.
Dirca Palustris ----- Dirca
Dolichos ----- Dol.
Doryphora ----- Dor.
Drosera ----- Dros.
Duboisinum ----- Dub.
Dulcamara ----- Dulc.
Echinacea Angustifolia ----- Echin.
Echinacea Purpurea ----- Echin. p.
Elæis Guineensis ----- Elæis
Elaps Corallinus ----- Elaps
Elaterium ----- Elat.
Electricitas ----- Elect.
Ephedra Vulgaris ----- Ephedra
Epigea Repens ----- Epigea
Epihysterinum ----- Epih.
Epilobium Palustre ----- Epil. p.
Epiphegus ----- Epiph.
Equisetum ----- Equis.
Erechthites ----- Erech.
Ergotinum ----- Ergotin
Erigeron ----- Erig.
Eriodictyon Glutinosum ----- Eriodyct.
Erodium ----- Erodium
Eryngium Aquaticum ----- Eryng. a.
Eryngium Maritimum ----- Eryng. m.
Erythrinus ----- Erythrin.
Erythroxylon ----- (see Coca) ----- Coca
Eserinum ----- Eserin.
Etherum ----- Ether.
Ethylum Nitricum ----- Ethyl.
Eucalyptus ----- Eucalyp.
Eugenia Jambos ----- Eug.
Euonyminum ----- Euonymin.
Euonymus Atropurpurea ----- Euon. atro.
Euonymus Europæa ----- Euon. europ.
Eupatorium Aromaticum ----- Eupat. arom.
Eupatorium Perfoliatum ----- Eupat. perf.
Eupatorium Purpureum ----- Eupat. purpur.
Euphorbia Amygdaloides ----- Euphorb. amyg.
Euphorbia Corollata ----- Euphorb. corol.
Euphorbia Cyparissias ----- Euphorb. cyparis.
Euphorbia Heterodoxa ----- Euphorb. heter.
Euphorbia Hypericifolia ----- Euphorb. hyperic.
Euphorbia Ipecacuanhæ ----- Euphorb. ipecac.
Euphorbia Lathyris ----- Euphorb. lath.
Euphorbia Peplus ----- Euphorb. peplus
Euphorbia Pilulifera ----- Euphorb. pil.
Euphorbium ----- Euphorb.
Euphrasia ----- Euphr.
Eupionum ----- Eupion.
Fagopyrum ----- Fago.
Fagus Sylvatica ----- Fagus
Fel Tauri ----- Fel. t.
Ferrum ----- Ferrum
Ferrum Arsenicicum ----- Fer. ars.
Ferrum Bromatum ----- Fer. bro.
Ferrum Iodatum ----- Fer. i.
Ferrum Magneticum ----- Fer. magn.
Ferrum Muriaticum ----- Fer. mur.
Ferrum Pernitricum ----- Fer. pernit.
Ferrum Phosphoricum ----- Fer. phos.
Ferrum Phosphoricum Hydricum ----- Fer. p. h.
Ferrum Picricum ----- Fer. pic.
Ferrum Pyrophosphoricum ----- Fer. pyroph.
Ferrum Sulphuricum ----- Fer. sul.
Ferrum Tartaricum ----- Fer. tart.
Ferula Glauca ----- Ferula
Ficus Religiosa ----- Ficus
Filix Mas ----- Filix
Fluoricum Acidum ----- Fluor. ac.
Formica ----- Form.
Fragaria Vesca ----- Frag. v.
Franciscea Uniflora ----- Franciscea u.
Franzensbad ----- Franz.
Fraxinus Americana ----- Fraxinus
Fucus Vesiculosus ----- Fucus
Gadus Morrhua ----- Gadus
Galega Officinalis ----- Galega
Galium Aparine ----- Galium
Gallicum Acidum ----- Gall. ac.
Galvanismus ----- Galva.
Gambogia ----- Gamb.
Gastein ----- Gastein
Gaultheria ----- Gaulth.
Gelsemium ----- Gels.
Genista ----- Genista
Gentiana Cruciata ----- Gent. cruc.
Gentiana Lutea ----- Gent. lutea
Gentiana Quinqueflora ----- Gent. quin.
Geranium Maculatum ----- Geranium
Gettysburg ----- Gettys.
Geum Rivale ----- Geum
Ginseng ----- Ginseng
Glinicum ----- (see Medorrhinum) ----- Medorrh.
Glonoinum ----- Glon.
Gnaphalium ----- Gnaph.
Gossypium Herbaceum ----- Gossyp.
Granatum ----- Granat.
Graphites ----- Graph.
Gratiola ----- Grat.
Grindelia ----- Grind. r.
Guaco ----- Guaco
Guaiacum ----- Guai.
Guarana ----- Guarana
Guarea ----- Guarea
Gummi Gutti ----- (see Gambogia) ----- Gamb.
Gymnema Sylvestre ----- Gymnema
Gymnocladus Canadensis ----- Gymnocl.
Gunpowder ----- Gunp.
Hæmatoxylon ----- Hæm.
Hall ----- Hall
Hamamelis ----- Ham.
Hecla ----- Hecla
Hedeoma ----- Hedeoma
Hedera helix ----- Hed. h.
Hedysarum Ildefonsianum ----- Hedysar.
Helianthus ----- Helianth.
Heliotropium ----- Heliot.
Helix Tosta ----- Helix t.
Helleborus Fœtidus ----- Hell. f.
Helleborus Niger ----- Hell. n.
Helleborus Orientalis ----- Hell. o.
Helleborus Viridis ----- Hell. v.
Heloderma ----- Helod.
Helonias ----- Helon.
Hepar ----- Hepar
Hepatica ----- Hepatica
Heracleum ----- Heracl.
Hippomanes ----- Hippom.
Hippozæninum ----- Hippoz.
Hoang-nan ----- Hoang-nan
Homarus ----- Homarus
Homeria ----- Homeria
Hura Brasiliensis ----- Hura bras.
Hura Crepitans ----- Hura crep.
Hydrangea Arborescens ----- Hydrang.
Hydrastininum Muriaticum ----- Hydrastinin. mur.
Hydrastinum Muriaticum ----- Hydrastinum mur.
Hydrastis Canadensis ----- Hydrastis
Hydrocotyle Asiatica ----- Hydrocot.
Hydrocyanicum Acidum ----- Hcyan. ac.
Hydrophobinum ----- Hydrob.
Hydrophyllum Virginianum ----- Hydrophyl. v.
Hyoscyaminum ----- Hyoscyamin.
Hyoscyamus ----- Hyo.
Hypericum ----- Hyp.
Iberis ----- Iber.
Icthyolum ----- Ichthol.
Ictodes Fœtida ----- Ictod.
Ignatia ----- Ign.
Ilex Aquifolium ----- Ilex
Illicium Anisatum ----- Illic.
Imperatoria ----- Imper.
Indigo ----- Indg.
Indium ----- Indm.
Influenzinum ----- Influ.
Inula ----- Inula
Iodium ----- Iod.
Iodoformum ----- Idf.
Ipecacuanha ----- Ipec.
Ipomœa ----- (see Convolvulus Duartinus) ----- Conv. d.
Iridium ----- Irid.
Iris Florentina ----- Ir. flor.
Iris Fœtidissima ----- Ir. fœt.
Iris Germanica ----- Ir. germ.
Iris Tenax ----- Ir. t.
Iris Versicolor ----- Ir. v.
Itu ----- Itu
Jaborandi ----- Jab.
Jacaranda Caroba ----- Jac. c.
Jacaranda Gualandai ----- Jac. g.
Jalapa ----- Jalap.
Jasminum ----- Jasmin.
Jatropha ----- Jatr.
Jatropha Urens ----- Jatr. u.
Jequirity ----- Jeq.
Juglans Cinerea ----- Jug. c.
Juglans Regia ----- Jug. r.
Juncus ----- Junc.
Juniperus Communis ----- Jun. c.
Juniperus Virginianus ----- Jun. v.
Kali Aceticum ----- Kali acet.
Kali Arsenicosum ----- Kali ars.
Kali Bichromicum ----- Kali bi.
Kali Bromatum ----- Kali bro.
Kali Carbonicum ----- Kali ca.
Kali Chloricum ----- Kali chlori.
Kali Chlorosum ----- Kali chloro.
Kali Citricum ----- Kali cit.
Kali Cyanatum ----- Kali cy.
Kali Ferrocyanatum ----- Kali fcy.
Kali Iodatum ----- Kali iod.
Kali Manganicum ----- (see Kali Permanganicum) ----- Kali pm.
Kali Muriaticum ----- Kali mur.
Kali Nitricum ----- Kali n.
Kali Oxalicum ----- Kali ox.
Kali Permanganicum ----- Kali pm.
Kali Phosphoricum ----- Kali ph.
Kali Picricum ----- Kali pi.
Kali Sulphuratum ----- Kali sulphurat.
Kali Sulphuricum ----- Kali sul.
Kali Tartaricum ----- Kali tart.
Kali Telluricum ----- Kali tel.
Kalmia Latifolia ----- Kalm.
Kamala ----- Kamala
Kaolin ----- Kao.
Karaka ----- Karaka
Katipo ----- (see Latrodectus Katipo) ----- Lat. k.
Kava Kava ----- (see Piper Methysticum) ----- Piper m.
Kerosolenum ----- Kerosol.
Kino ----- Kino. ----- (see Angophora ----- Angoph.)
Kissingen ----- Kis.
Kousso ----- Kousso
Krameria ----- (see Ratanhia) ----- Rat.
Kreosotum ----- Kre.
Laburnum ----- Laburn.
Lac Caninum ----- Lac can.
Lac Felinum ----- Lac fel.
Lac Vaccinum ----- Lac vac.
Lac Vaccinum Coagulatum ----- Lac v. coag.
Lac Vaccinum Defloratum ----- Lac v. def.
Lacerta ----- Lacerta
Lachesis ----- Lach.
Lachnanthes ----- Lachn.
Lacticum Acidum ----- Lact. ac.
Lactis Vaccini Flos ----- Lac. v. fl.
Lactuca Virosa ----- Lact. vir.
Lamium ----- Lamium
Lapathum ----- Lapath.
Lapis Albus ----- Lap. a.
Lappa ----- (see Arctium Lappa) ----- Arct.
Lapsana Communis ----- Lapsana
Lathyrus ----- Lath.
Latrodectus Katipo ----- Lat. k.
Latrodectus Mactans ----- Lat. mac.
Laurocerasus ----- Lauro.
Ledum ----- Led.
Lemna Minor ----- Lemna
Leonurus Cardiaca ----- Leo.
Lepidium Bonariense ----- Lep. bon.
Leptandra ----- Lept.
Levico ----- Levico
Liatris Spicata ----- Liatris
Lilium Tigrinum ----- Lil. t.
Limulus ----- Limulus
Linaria ----- Linar.
Linum Catharticum ----- Lin. cath.
Linum Usitatissimum ----- Lin. us.
Lippia Mexicana ----- Lippia
Lippspringe ----- Lipps.
Lithium Benzoicum ----- Lith. benz.
Lithium Bromatum ----- Lith. bro.
Lithium Carbonicum ----- Lith. c.
Lithium Lacticum ----- Lith. lact.
Lithium Muriaticum ----- Lith. mur.
Lobelia Cardinalis ----- Lob. card.
Lobelia Dortmanna ----- Lob. d.
Lobelia Erinus ----- Lob. er.
Lobelia Inflata ----- Lob. i.
Lobelia Purpurascens ----- Lob. purp.
Lobelia Syphilitica ----- Lob. syph.
Loco-weed ----- (see Oxytropis Lamberti) ----- Oxyt. lamberti
Lolium Temulentum ----- Lol. tem.
Lonicera Periclymenum ----- Lon. peri.
Lonicera Xylosteum ----- Lon. xylost.
Luesinum, or Lueticum ----- (see Syphilinum) ----- Syph.
Luna ----- Luna
Lupulus ----- Lup.
Lycopersicum ----- Lycopers.
Lycopodium ----- Lyc.
Lycopus ----- Lcps.
Lysidinum ----- Lysidin.
Macrotinum ----- Macrot.
Magnesia Carbonica ----- Mag. c.
Magnesia Muriatica ----- Mag. m.
Magnesia Phosphorica ----- Mag. p.
Magnesia Sulphurica ----- Mag. s.
Magnetis Poli Ambo ----- M. p. amb.
Magnetis Polus Arcticus ----- M. p. arct.
Magnetis Polus Australis ----- M. p. aust.
Magnolia Glauca ----- Mgl. gl.
Magnolia Grandiflora ----- Mgl. grand.
Maïs and Stigmata Maidis ----- (see Zea Mays) ----- Zea
Malandrinum ----- Maland.
Malaria Officinalis ----- Malar.
Mancinella ----- Manc.
Mandragora ----- Mand.
Manganum ----- Mang.
Manganum Aceticum ----- (see Manganum) ----- Mang.
Manganum Carbonicum ----- (see Manganum) ----- Mang.
Manganum Muriaticum ----- Mang. mur.
Manganum Oxydatum Nativum ----- Mang. ox. n.
Manganum Sulphuricum ----- Mang. sulph.
Matthiola Græca ----- Matt. g.
Medorrhinum ----- Medorrh.
Medusa ----- Medusa
Melastoma ----- Melast.
Melilotus ----- Melil.
Melitagrinum ----- Melit.
Menispermum ----- Meni.
Mentha Piperita ----- Menth. pip.
Mentha Pulegium ----- Menth. pul.
Menyanthes ----- Meny.
Mephitis ----- Meph.
Mercurialis Perennis ----- Merls.
Mercurius ----- Merc.
Mercurius Aceticus ----- Merc. ac.
Mercurius Biniodatus ----- Merc. bin.
Mercurius Biniodatus cum Kali Iodatum ----- Merc. k. i.
Mercurius Corrosivus ----- Merc. cor.
Mercurius Cyanatus ----- Merc. cy.
Mercurius Dulcis ----- Merc. dulc.
Mercurius Nitricus ----- Merc. nit.
Mercurius Oxydulatus Niger (M. Sol. Hahn.) ----- (see Mercurius) ----- Merc.
Mercurius Præcipitatus Albus ----- Merc. præcip. alb.
Mercurius Præcipitatus Ruber ----- Merc. præcip. rub.
Mercurius Protoiodatus ----- Merc. iod.
Mercurius Solubilis Hahnemanni ----- (see Mercurius) ----- Merc.
Mercurius Sulphocyanatus ----- Merc. sulcy.
Mercurius Sulphuratus Ruber ----- (see Cinnabaris) ----- Cinnab.
Mercurius Sulphuricus ----- Merc. sul.
Mercurius Vivus ----- (see Mercurius) ----- Merc.
Methylene-blue ----- Meth.-b.
Mezereum ----- Mez.
Millefolium ----- Mill.
Mimosa ----- Mimosa
Mitchella ----- Mitch.
Momordica ----- Mom.
Morbillinum ----- Morbil.
Morphinum ----- Morph.
Morphinum Aceticum ----- (see Morphinum) ----- Morph.
Morphinum Muriaticum ----- (see Morphinum) ----- Morph.
Morphinum Sulphuricum ----- (see Morphinum) ----- Morph.
Moschus ----- Mosch.
Mucuna Pruriens ----- (see Dolichos) ----- Dol.
Mucuna Urens ----- M. urens
Murex ----- Murex
Muriaticum Acidum ----- Mur. ac.
Musa ----- Musa
Mygale ----- Myg.
Myosotis ----- Myos.
Myrica Cerifera ----- Myrica
Myristica Sebifera ----- Myr. seb.
Myrtus Communis ----- Myrt. com.
Nabalus ----- Nab.
Naja ----- Naja
Naphthalinum ----- Naph.
Narcissus ----- Narci.
Narcotinum ----- Narco.
Natrum Arsenicicum ----- Nat. ars.
Natrum Cacodylicum ----- Nat. cac.
Natrum Carbonicum ----- Nat. carb.
Natrum Hypochlorosum ----- Nat. hyp.
Natrum Iodatum ----- Nat. iod.
Natrum Lacticum ----- Nat. lact.
Natrum Muriaticum ----- Nat. m.
Natrum Nitricum ----- Nat. n.
Natrum Nitrosum ----- Nat. nitros.
Natrum Phosphoricum ----- Nat. phos.
Natrum Salicylicum ----- Nat. sal.
Natrum Selenicum ----- Nat. sel.
Natrum Silicofluoricum ----- Nat. sil.
Natrum Sulphuricum ----- Nat. sul.
Natrum Sulphurosum ----- Nat. sulphuros.
Nectrianinum ----- Nectr.
Niccolum ----- Nicc.
Niccolum carbonicum ----- (see Niccolum) ----- Nicc.
Niccolum metallicum ----- (see Niccolum) ----- Nicc.
Niccolum Sulphuricum ----- Nicc. s.
Nicotinum ----- Nicotin.
Nitri Spiritus Dulcis ----- Nit. spi. dulc.
Nitricum Acidum ----- Nit. ac.
Nitrogenum Oxygenatum ----- Nit. ox.
Nitroso-muriaticum Acidum ----- Nit. mur. ac.
Nitrum ----- (see Kali Nitricum) ----- Kali n.
Nuphar Luteum ----- Nuph.
Nux juglans ----- (see Juglans Regia) ----- Jug. r.
Nux Moschata ----- Nux. m.
Nux Vomica ----- Nux. v.
Nyctanthes ----- Nyct.
Nymphæa Odorata ----- Nymph.
Ocimum Canum ----- Ocim. can.
Œnanthe Crocata ----- Œn. c.
Œnothera ----- Œnoth.
Oleander ----- Olean.
Oleum Animale ----- Ol. an.
Oleum Jecoris Aselli ----- Ol. j. a.
Oleum Ricini ----- (see Ricinus) ----- Ric.
Oniscus ----- Onis.
Ononis ----- Onon.
Onosmodium ----- Onos.
Oophorinum ----- Ooph.
Opium ----- Op.
Opuntia ----- Opun.
Orchitinum ----- Orch.
Oreodaphne ----- Oreod.
Origanum ----- Orig.
Ornithogalum ----- Ornith.
Osmium ----- Osm.
Ostrya ----- Ost.
Ovi Gallinæ Pellicula ----- Ovi g. p.
Ovi Gallinæ Testa ----- (see Calcarea Ovi Testa) ----- Calc. ov. test.
Oxalicum Acidum ----- Oxal. ac.
Oxydendron ----- Oxydend.
Oxygenium ----- Oxy.
Oxytropis Lamberti ----- Oxyt. lamberti
Ozonum ----- (see Oxygenium) ----- Oxy.
Pæonia ----- Pæon.
Palladium ----- Pallad.
Pancreatinum ----- Pancr.
Papaya ----- (see Asimina) ----- Asimina
Paraffinum ----- Paraf.
Pareira ----- Par. b.
Parietaria ----- Pariet.
Paris ----- Paris
Parotidinum ----- Parot.
Parthenium ----- Parthen.
Passiflora ----- Passif.
Pastinaca ----- Past.
Paullinia Pinnata ----- Paul. p.
Paullinia Sorbilis ----- (see Guarana) ----- Guarana
Pecten ----- Pecten
Pediculus ----- Pedic.
Pelargonium Reniforme ----- Pel. ren.
Penthorum Sedoides ----- Penth. s.
Pepsinum ----- Pepsin.
Persica ----- Pers.
Persicaria Urens ----- (see Polygonum) ----- Polyg.
Pestinum ----- Pest.
Petiveria ----- Petiv.
Petroleum ----- Petrol.
Petroselinum ----- Petrosel.
Phallus Impudicus ----- Phallus
Phaseolus ----- Phas.
Phellandrium ----- Phelland.
Phenacetinum ----- Phenacet.
Phlorizinum ----- Phlor.
Phosphoricum Acidum ----- Pho. ac.
Phosphorus ----- Pho.
Phosphorus Hydrogenatus ----- Pho. hydr.
Phosphorus Muriaticus ----- Pho. mur.
Physalia ----- Physal.
Physostigma ----- Physo.
Phytolacca ----- Phyt.
Pichi ----- Pichi
Picricum Acidum ----- Pic. ac.
Picrotoxinum ----- Picro.
Pilocarpinum ----- Pilo.
Pilocarpinum muriaticum ----- (see Pilocarpinum) ----- Pilo.
Pilocarpinum nitricum ----- (see Pilocarpinum) ----- Pilo.
Pimenta ----- Pimenta
Pimpernel ----- (see Anagallis) ----- Anag.
Pimpinella ----- Pimp.
Pinus Lambertiana ----- Pin. lamb.
Pinus Sylvestris ----- Pin. syl.
Piper Methysticum ----- Piper m.
Piper Nigrum ----- Piper nig.
Piperazinum ----- Piperaz.
Piscidia ----- Piscidia
Pix Liquida ----- Pix
Plantago ----- Plant.
Platanus ----- Platanus
Platinum ----- Plat.
Platinum Muriaticum ----- Plat. mur.
Platinum Muriaticum Natronatum ----- Plat. m. n.
Plectranthus ----- Plectr.
Plumbago ----- Plumbago
Plumbum ----- Plumb.
Plumbum Chromicum ----- Plumb. chr.
Plumbum Iodatum ----- Plumb. iod.
Podophyllum ----- Pod.
Polygonum ----- Polyg.
Polygonum Acre ----- (see Polygonum) ----- Polyg.
Polygonum Hydopiper ----- (see Polygonum) ----- Polyg.
Polyporus Officinalis ----- (see Boletus Laricis) ----- Bol. lar.
Polyporus Pinicola ----- Pol. pin.
Populus Candicans ----- Pop. c.
Populus Tremuloides ----- Pop. t.
Pothos Fœtidus ----- (see Ictodes) ----- Ictod.
Primula Obconca ----- Prim. ob.
Primula Veris ----- Prim. ver.
Primula Vulgaris ----- Prim. vulg.
Prinos Verticillatus ----- Prin. v.
Propylaminum ----- (see Trimethylaminum) ----- Trimethyl.
Prunus Padus ----- Prun. pd.
Prunus Spinosa ----- Prun. spi.
Prunus Virginiana ----- Prun. virg.
Psorinum ----- Pso.
Ptelea ----- Pte.
Pulmo Vulpis ----- Pulmo v.
Pulsatilla ----- Puls.
Pulsatilla Nuttaliana ----- Puls. nutt.
Pyrethrum Parthenium ----- Pyr. p.
Pyrogenium ----- Pyro.
Pyrus Americana ----- Pyrus amer.
Quassia ----- Quassia
Quebracho ----- Queb.
Quercus ----- Quer.
Quininum ----- (see Chininum Sulphuricum) ----- Chi. sul.
Radium Bromatum ----- Rad. b.
Ranunculus Acris ----- Ran. acris.
Ranunculus Bulbosus ----- Ran. bulb.
Ranunculus Ficaria ----- Ran. ficaria
Ranunculus Flammula ----- Ran. flam.
Ranunculus Glacialis ----- Ran. glac.
Ranunculus Repens ----- Ran. rep.
Ranunculus Sceleratus ----- Ran. sc.
Raphanus ----- Rap.
Ratanhia ----- Rat.
Rhamnus Catharticus ----- Rh. ca.
Rhamnus Frangula ----- Rh. fr.
Rheum ----- Rhe.
Rhodium Oxydatum Nitricum ----- Rhod. o. n.
Rhododendron ----- Rhod.
Rhus Aromatica ----- Rh. a.
Rhus Diversiloba ----- Rh. d.
Rhus Glabra ----- Rh. g.
Rhus Radicans ----- (see Rhus Toxicodendron) ----- Rh. t.
Rhus Toxicodendron ----- Rh. t.
Rhus Venenata ----- Rh. v.
Ricinus ----- Ric.
Robinia ----- Rob.
Rosa Canina ----- Rosa can.
Rosa Damascena ----- Rosa dam.
Rosmarinus ----- Rosm.
Rubia Tinctorum ----- Rub. t.
Rumex Acetosa ----- Rx. a.
Rumex Crispus ----- Rx. c.
Rumex Obtusifolia ----- (see Lapathum) ----- Lapath.
Russula ----- Russula
Ruta ----- Ruta
Sabadilla ----- Saba.
Sabal Serrulata ----- Sbl.
Sabina ----- Sbi.
Saccharum Lactis ----- Sac. l.
Saccharum Officinale ----- Sac. off.
Salicinum ----- Saln.
Salicylicum Acidum ----- Sal. ac.
Salix Mollissima ----- Sal. mollis.
Salix Nigra ----- Sal. n.
Salix Purpurea ----- Sal. purp.
Salol ----- Salol
Salufer ----- (see Natrum Silicofluoricum) ----- Nat. sil.
Salvia ----- Salvia
Sambucus Canadensis ----- Samb. can.
Sambucus Nigra ----- Samb. nig.
Sanguinaria ----- Sang.
Sanguinarinum ----- Sng.
Sanguinarinum Nitricum ----- Sng. nit.
Sanguinarinum Tartaricum ----- Sng. tart.
Sanguisuga ----- Sngs.
Sanicula ----- Sanic.
Santalum ----- Santal.
Santoninum ----- Santonin.
Saponinum ----- Sap.
Sarracenia ----- Sarr.
Sarsaparilla ----- Sars.
Scammonium ----- Scam.
Scarlatininum ----- Scarlatinin.
Schinus ----- Schinus
Scilla Maritima ----- Scil.
Scirrhinum ----- Scirrh.
Scolopendra ----- Scol.
Scorpio ----- Scorp.
Scrophularia ----- Scrph.
Scutellaria ----- Scut.
Secale Cornutum ----- Sec.
Selenium ----- Sel.
Sempervivum Tectorum ----- Semp.
Senecio Aureus ----- Senec.
Senecio Jacobœa ----- Sen. jac.
Senega ----- Seneg.
Senna ----- Senna
Sepia ----- Sep.
Sepsinum ----- (see Pyrogenium) ----- Pyro.
Septicæminum ----- Septic.
Shucks ----- (see Zea) ----- Zea
Silica ----- Sil.
Silica Marina ----- Sil. mar.
Silphium ----- Silph.
Simaruba ----- Simb.
Sinapis Alba ----- Sin. alb.
Sinapis Nigra ----- Sin. nig.
Sium ----- Sium
Skookum Chuck ----- Skoo.
Slag ----- Slag.
Sol ----- Sol.
Solaninum ----- Solan.
Solaninum Aceticum ----- (see Solaninum) ----- Solan.
Solanum Arrebenta ----- Sol. arr.
Solanum Carolinense ----- Sol. car.
Solanum Mammosum ----- Sol. mam.
Solanum Nigrum ----- Sol. n.
Solanum Oleraceum ----- Sol. ol.
Solanum Pseudo-Capsicum ----- Sol. p. c.
Solanum Tuberosum ----- Sol. t.
Solanum Tuberosum Ægrotans ----- Sol. t. æ.
Solidago ----- Solid.
Sperminum ----- (see Orchitinum) ----- Orch.
Sphingurus ----- Sph.
Spigelia ----- Spi.
Spigelia Marilandica ----- Spi. m.
Spiræa Ulmaria ----- Spir.
Spiranthes ----- Spiran.
Spongia Tosta ----- Spo.
Stachys Betonica ----- Stach.
Stannum ----- Stan.
Stannum Iodatum ----- Stan. iod.
Staphisagria ----- Staph.
Stellaria Media ----- Stel.
Sticta Pulmonaria ----- Stic.
Stigmata Maïdis ----- (see Zea) ----- Zea
Stillingia Sylvatica ----- Still.
Stramonium ----- Stram.
Strontium Bromatum ----- Stro. bro.
Strontium Carbonicum ----- Stro. c.
Strontium Nitricum ----- Stront. nit.
Strophanthus ----- Strop.
Strychninum ----- Strych.
Strychninum Nitricum ----- (see Strychninum) ----- Strych.
Strychninum Phosphorinum ----- (see Strychninum) ----- Strych.
Strychninum Sulphuricum ----- (see Strychninum) ----- Strych.
Strychninum Valerianicum ----- (see Strychninum) ----- Strych.
Succinum ----- Succ.
Sulfonal ----- Sfo.
Sulphur ----- Sul.
Sulphur Hydrogenisatum ----- Sul. h.
Sulphur Iodatum ----- Sul. iod.
Sulphur Terebinthinatum ----- Sul. tereb.
Sulphuricum Acidum ----- Sul. ac.
Sulphurosum Acidum ----- Suls. ac.
Sumbul ----- Sumb.
Symphoricarpus Racemosus ----- Smpho. r.
Symphytum ----- Symph.
Syphilinum ----- Syph.
Syzygium ----- Syz.
Tabacum ----- Tab.
Tamus ----- Tamus.
Tanacetum ----- Tan.
Tanghinia ----- Tanghinia
Tannin ----- Tannin
Taraxacum ----- Trx.
Tarentula ----- Trn.
Tarentula Cubensis ----- Trn. c.
Tartaricum Acidum ----- Tart. ac.
Taxus Baccata ----- Tax.
Tellurium ----- Tell.
Teplitz ----- Teplitz
Terebinthina ----- Ter.
Tetradymite ----- Tetr.
Teucrium Marum Verum ----- Teuc. m.
Teucrium Scorodonia ----- Teuc. s.
Thallium ----- Thal.
Thea ----- Thea
Theridion ----- Therid.
Thevetia ----- Thev.
Thiosinaminum ----- Thios.
Thlaspi Bursa Pastoris ----- Thlasp.
Thuja ----- Thuja
Thyroidinum ----- Thyr.
Thyroiodinum ----- Thyri.
Tilia ----- Til.
Titanium ----- Titan.
Tongo ----- Tong.
Toxicophis ----- Tox.
Trachinus ----- Trach.
Tradescantia ----- Trad.
Trifolium Pratense ----- Tri. p.
Trifolium Repens ----- Tri. r.
Trillium ----- Trill.
Trimethylaminum ----- Trimethyl.
Triosteum ----- Triost.
Triticum Repens ----- Trit. r.
Trombidium ----- Tromb.
Tropæolum ----- Trop.
Tuberculinum ----- Tub.
Turnera Aphrodisiaca ----- Turn. a.
Tussilago Farfara ----- Tus. far.
Tussilago Fragrans ----- Tus. fg.
Tussilago Petasites ----- Tus. p.
Ulmus Fulva ----- Ulmus
Upas ----- Up.
Uranium Nitricum ----- Ur. nit.
Urea ----- Urea
Uricum Acidum ----- Uric ac.
Urinum ----- Urinum
Urtica Urens ----- Urt. u.
Usnea Barbata ----- Usn. b.
Ustilago ----- Ust.
Uva-Ursi ----- Uva
Vaccininum ----- Vacc.
Vaccinium Myrtillus ----- Vacc. m.
Valeriana ----- Val.
Vanadium ----- Van.
Variolinum ----- Var.
Veratrinum ----- Vern.
Veratrum Album ----- Ver. a.
Veratrum Nigrum ----- Ver. nig.
Veratrum Viride ----- Ver. v.
Verbascum ----- Verb.
Verbena Hastata ----- Verbena h.
Vesicaria ----- Vesic.
Vespa ----- Vesp.
Viburnum Opulus ----- Vib. o.
Viburnum Prunifolium ----- Vib. p.
Viburnum Tinus ----- Vib. t.
Vichy ----- Vichy
Vinca Minor ----- Vinca
Viola Odorata ----- V. od.
Viola Tricolor ----- V. tri.
Vipera ----- Vip.
Viscum Album ----- Visc.
Vœslau ----- Voeslau
Wiesbaden ----- Wiesb.
Wildbad ----- Wildb.
Wyethia ----- Wyeth.
Xanthoxylum ----- Xan.
Yohimbinum ----- Yohim.
Yucca Filamentosa ----- Yuc.
Zea ----- Zea
Zincum ----- Zn.
Zincum Aceticum ----- Zn. ac.
Zincum Bromatum ----- Zn. br.
Zincum Cyanatum ----- Zn. cy.
Zincum Iodatum ----- Zn. i.
Zincum Muriaticum ----- Zn. m.
Zincum Oxydatum ----- Zn. o.
Zincum Phosphoricum ----- Zn. ph.
Zincum Picricum ----- Zn. pi.
Zincum Sulphuricum ----- Zn. s.
Zincum Valerianicum ----- Zn. v.
Zingiber ----- Zng.
Zizia ----- Ziz.